"Rk","Player","Player_Href","Nation","Pos","Squad","Age","Born","Mins_Per_90","Tkl_Tackles","TklW_Tackles","Def 3rd_Tackles","Mid 3rd_Tackles","Att 3rd_Tackles","Tkl_Challenges","Att_Challenges","Tkl_percent_Challenges","Lost_Challenges","Blocks_Blocks","Sh_Blocks","Pass_Blocks","Int","Tkl+Int","Clr","Err","Matches","url"
1,"Max Aarons","/en/players/774cf58b/Max-Aarons","eng ENG","DF","Bournemouth",23,2000,13.7,29,19,20,7,2,20,34,58.8,14,9,5,4,8,37,27,0,"Matches","https://fbref.com/en/comps/9/2023-2024/defense/2023-2024-Premier-League-Stats"
2,"Joshua Acheampong","/en/players/b7e62e1d/Joshua-Acheampong","eng ENG","DF","Chelsea",17,2006,0.1,0,0,0,0,0,0,0,NA,0,3,3,0,0,0,0,0,"Matches","https://fbref.com/en/comps/9/2023-2024/defense/2023-2024-Premier-League-Stats"
3,"Tyler Adams","/en/players/2b09d998/Tyler-Adams","us USA","MF","Bournemouth",24,1999,1.3,4,3,1,3,0,2,3,66.7,1,2,0,2,4,8,2,0,"Matches","https://fbref.com/en/comps/9/2023-2024/defense/2023-2024-Premier-League-Stats"
4,"Tosin Adarabioyo","/en/players/c81d773d/Tosin-Adarabioyo","eng ENG","DF","Fulham",25,1997,18,21,11,16,5,0,12,21,57.1,9,16,11,5,25,46,80,0,"Matches","https://fbref.com/en/comps/9/2023-2024/defense/2023-2024-Premier-League-Stats"
5,"Elijah Adebayo","/en/players/0480ebc7/Elijah-Adebayo","eng ENG","FW","Luton Town",25,1998,15.8,4,1,1,0,3,1,12,8.3,11,13,2,11,6,10,25,0,"Matches","https://fbref.com/en/comps/9/2023-2024/defense/2023-2024-Premier-League-Stats"
6,"Simon Adingra","/en/players/4dcec659/Simon-Adingra","ci CIV","FW","Brighton",21,2002,24.7,45,20,23,11,11,19,42,45.2,23,31,1,30,19,64,22,0,"Matches","https://fbref.com/en/comps/9/2023-2024/defense/2023-2024-Premier-League-Stats"
7,"Nayef Aguerd","/en/players/288e1e13/Nayef-Aguerd","ma MAR","DF","West Ham",27,1996,20.6,26,14,19,7,0,16,22,72.7,6,33,24,9,17,43,85,2,"Matches","https://fbref.com/en/comps/9/2023-2024/defense/2023-2024-Premier-League-Stats"
8,"Brandon Aguilera","/en/players/938fa024/Brandon-Aguilera","cr CRC","FW","Nott'ham Forest",20,2003,0.1,0,0,0,0,0,0,0,NA,0,0,0,0,0,0,0,0,"Matches","https://fbref.com/en/comps/9/2023-2024/defense/2023-2024-Premier-League-Stats"
9,"Naouirou Ahamada","/en/players/a6c58494/Naouirou-Ahamada","fr FRA","MF,FW","Crystal Palace",21,2002,3.9,13,9,5,6,2,8,17,47.1,9,3,0,3,2,15,4,0,"Matches","https://fbref.com/en/comps/9/2023-2024/defense/2023-2024-Premier-League-Stats"
10,"Anel Ahmedhodžić","/en/players/eab957a3/Anel-Ahmedhodzic","ba BIH","DF","Sheffield Utd",24,1999,29.4,64,36,48,14,2,30,49,61.2,19,43,26,17,34,98,137,2,"Matches","https://fbref.com/en/comps/9/2023-2024/defense/2023-2024-Premier-League-Stats"
11,"Ola Aina","/en/players/246d153b/Ola-Aina","ng NGA","DF","Nott'ham Forest",26,1996,18.8,47,31,31,12,4,29,40,72.5,11,19,3,16,18,65,51,1,"Matches","https://fbref.com/en/comps/9/2023-2024/defense/2023-2024-Premier-League-Stats"
12,"Rayan Aït-Nouri","/en/players/9b398aea/Rayan-Ait-Nouri","dz ALG","DF,MF","Wolves",22,2001,25.9,71,44,41,23,7,28,49,57.1,21,32,6,26,15,86,38,0,"Matches","https://fbref.com/en/comps/9/2023-2024/defense/2023-2024-Premier-League-Stats"
13,"Kristoffer Ajer","/en/players/a8c0acb7/Kristoffer-Ajer","no NOR","DF","Brentford",25,1998,20.4,38,21,25,9,4,23,36,63.9,13,26,11,15,25,63,79,1,"Matches","https://fbref.com/en/comps/9/2023-2024/defense/2023-2024-Premier-League-Stats"
14,"Manuel Akanji","/en/players/89ac64a6/Manuel-Akanji","ch SUI","DF,MF","Manchester City",28,1995,27.9,42,28,16,18,8,22,39,56.4,17,28,12,16,23,65,70,3,"Matches","https://fbref.com/en/comps/9/2023-2024/defense/2023-2024-Premier-League-Stats"
15,"Nathan Aké","/en/players/eaeca114/Nathan-Ake","nl NED","DF","Manchester City",28,1995,22.7,26,16,15,8,3,13,20,65,7,17,2,15,14,40,54,0,"Matches","https://fbref.com/en/comps/9/2023-2024/defense/2023-2024-Premier-League-Stats"
16,"Thiago Alcántara","/en/players/77e84962/Thiago-Alcantara","es ESP","MF","Liverpool",32,1991,0.1,0,0,0,0,0,0,0,NA,0,0,0,0,0,0,0,0,"Matches","https://fbref.com/en/comps/9/2023-2024/defense/2023-2024-Premier-League-Stats"
17,"Trent Alexander-Arnold","/en/players/cd1acf9d/Trent-Alexander-Arnold","eng ENG","DF","Liverpool",24,1998,23.9,39,26,26,11,2,27,87,31,60,22,2,20,31,70,48,5,"Matches","https://fbref.com/en/comps/9/2023-2024/defense/2023-2024-Premier-League-Stats"
18,"Alisson","/en/players/7a2e46a8/Alisson","br BRA","GK","Liverpool",30,1992,28,0,0,0,0,0,0,1,0,1,0,0,0,0,0,11,4,"Matches","https://fbref.com/en/comps/9/2023-2024/defense/2023-2024-Premier-League-Stats"
19,"Miguel Almirón","/en/players/862a1c15/Miguel-Almiron","py PAR","FW","Newcastle Utd",29,1994,21.5,36,24,13,15,8,11,29,37.9,18,29,2,27,10,46,13,0,"Matches","https://fbref.com/en/comps/9/2023-2024/defense/2023-2024-Premier-League-Stats"
20,"Edson Álvarez","/en/players/8b3ab7ad/Edson-Alvarez","mx MEX","MF","West Ham",25,1997,26.4,80,39,47,26,7,31,66,47,35,59,20,39,42,122,81,0,"Matches","https://fbref.com/en/comps/9/2023-2024/defense/2023-2024-Premier-League-Stats"
21,"Julián Álvarez","/en/players/15ab5a2b/Julian-Alvarez","ar ARG","MF,FW","Manchester City",23,2000,29.4,24,13,5,8,11,8,32,25,24,30,0,30,2,26,14,1,"Matches","https://fbref.com/en/comps/9/2023-2024/defense/2023-2024-Premier-League-Stats"
22,"Zeki Amdouni","/en/players/2ee5b0c9/Zeki-Amdouni","ch SUI","FW","Burnley",22,2000,21.7,27,18,1,15,11,7,25,28,18,23,10,13,9,36,10,0,"Matches","https://fbref.com/en/comps/9/2023-2024/defense/2023-2024-Premier-League-Stats"
23,"Sofyan Amrabat","/en/players/5a2cb25d/Sofyan-Amrabat","ma MAR","MF,DF","Manchester Utd",26,1996,10.4,27,16,17,8,2,17,31,54.8,14,20,7,13,8,35,19,2,"Matches","https://fbref.com/en/comps/9/2023-2024/defense/2023-2024-Premier-League-Stats"
24,"Joachim Andersen","/en/players/e34fc66d/Joachim-Andersen","dk DEN","DF","Crystal Palace",27,1996,37.9,56,35,33,21,2,29,39,74.4,10,33,18,15,41,97,207,1,"Matches","https://fbref.com/en/comps/9/2023-2024/defense/2023-2024-Premier-League-Stats"
25,"Elliot Anderson","/en/players/de31038e/Elliot-Anderson","eng ENG","MF,FW","Newcastle Utd",20,2002,11.4,24,18,12,9,3,15,29,51.7,14,23,4,19,8,32,23,0,"Matches","https://fbref.com/en/comps/9/2023-2024/defense/2023-2024-Premier-League-Stats"
26,"Jaidon Anthony","/en/players/e4238fb1/Jaidon-Anthony","eng ENG","FW","Bournemouth",23,1999,1.7,3,1,1,0,2,1,7,14.3,6,3,0,3,1,4,3,0,"Matches","https://fbref.com/en/comps/9/2023-2024/defense/2023-2024-Premier-League-Stats"
27,"Michail Antonio","/en/players/ac05f970/Michail-Antonio","jm JAM","FW","West Ham",33,1990,18.8,15,8,5,6,4,3,11,27.3,8,16,3,13,4,19,4,0,"Matches","https://fbref.com/en/comps/9/2023-2024/defense/2023-2024-Premier-League-Stats"
28,"Antony","/en/players/99127249/Antony","br BRA","FW","Manchester Utd",23,2000,14.7,40,21,15,19,6,20,40,50,20,29,1,28,12,52,9,0,"Matches","https://fbref.com/en/comps/9/2023-2024/defense/2023-2024-Premier-League-Stats"
29,"Oliver Arblaster","/en/players/afe1a491/Oliver-Arblaster","eng ENG","MF","Sheffield Utd",19,2004,10.5,23,14,11,8,4,7,15,46.7,8,17,7,10,16,39,9,0,"Matches","https://fbref.com/en/comps/9/2023-2024/defense/2023-2024-Premier-League-Stats"
30,"Cameron Archer","/en/players/05e8ca6d/Cameron-Archer","eng ENG","FW,MF","Sheffield Utd",22,2001,20.4,18,13,6,6,6,8,18,44.4,10,22,3,19,1,19,11,0,"Matches","https://fbref.com/en/comps/9/2023-2024/defense/2023-2024-Premier-League-Stats"
31,"Cameron Archer","/en/players/05e8ca6d/Cameron-Archer","eng ENG","MF","Aston Villa",22,2001,0.1,0,0,0,0,0,0,0,NA,0,0,0,0,0,0,0,0,"Matches","https://fbref.com/en/comps/9/2023-2024/defense/2023-2024-Premier-League-Stats"
32,"Alphonse Areola","/en/players/2f965a72/Alphonse-Areola","fr FRA","GK","West Ham",30,1993,30,1,1,1,0,0,1,3,33.3,2,0,0,0,1,2,16,0,"Matches","https://fbref.com/en/comps/9/2023-2024/defense/2023-2024-Premier-League-Stats"
33,"Lorenz Assignon","/en/players/b026bbf6/Lorenz-Assignon","tg TOG","DF","Burnley",23,2000,13.7,35,17,18,13,4,14,27,51.9,13,22,7,15,19,54,43,1,"Matches","https://fbref.com/en/comps/9/2023-2024/defense/2023-2024-Premier-League-Stats"
34,"Serge Aurier","/en/players/5c2b4f07/Serge-Aurier","ci CIV","DF,MF","Nott'ham Forest",30,1992,9.3,20,14,9,11,0,5,11,45.5,6,10,3,7,9,29,36,1,"Matches","https://fbref.com/en/comps/9/2023-2024/defense/2023-2024-Premier-League-Stats"
35,"Taiwo Awoniyi","/en/players/e5478b87/Taiwo-Awoniyi","ng NGA","FW","Nott'ham Forest",25,1997,11.6,9,7,1,4,4,1,2,50,1,7,2,5,1,10,9,0,"Matches","https://fbref.com/en/comps/9/2023-2024/defense/2023-2024-Premier-League-Stats"
36,"Jordan Ayew","/en/players/da052c14/Jordan-Ayew","gh GHA","FW,MF","Crystal Palace",31,1991,28.3,65,36,23,28,14,21,42,50,21,43,2,41,16,81,15,0,"Matches","https://fbref.com/en/comps/9/2023-2024/defense/2023-2024-Premier-League-Stats"
37,"Benoît Badiashile","/en/players/06df8256/Benoit-Badiashile","fr FRA","DF","Chelsea",22,2001,14.9,21,15,12,9,0,9,14,64.3,5,21,14,7,18,39,66,2,"Matches","https://fbref.com/en/comps/9/2023-2024/defense/2023-2024-Premier-League-Stats"
38,"Leon Bailey","/en/players/3a233281/Leon-Bailey","jm JAM","MF,FW","Aston Villa",25,1997,23,13,7,7,4,2,5,20,25,15,18,1,17,9,22,6,0,"Matches","https://fbref.com/en/comps/9/2023-2024/defense/2023-2024-Premier-League-Stats"
39,"Stefan Bajcetic","/en/players/32e8417f/Stefan-Bajcetic","es ESP","MF","Liverpool",18,2004,0.3,4,1,3,1,0,3,5,60,2,0,0,0,0,4,0,0,"Matches","https://fbref.com/en/comps/9/2023-2024/defense/2023-2024-Premier-League-Stats"
40,"George Baldock","/en/players/394854c4/George-Baldock","gr GRE","DF","Sheffield Utd",30,1993,10.8,18,10,10,7,1,6,15,40,9,14,8,6,10,28,33,0,"Matches","https://fbref.com/en/comps/9/2023-2024/defense/2023-2024-Premier-League-Stats"
41,"Carlos Baleba","/en/players/a1390d2f/Carlos-Baleba","cm CMR","MF","Brighton",19,2004,14.7,40,20,17,19,4,23,46,50,23,35,7,28,18,58,30,3,"Matches","https://fbref.com/en/comps/9/2023-2024/defense/2023-2024-Premier-League-Stats"
42,"Fodé Ballo-Touré","/en/players/f449640d/Fode-Ballo-Toure","sn SEN","DF,MF","Fulham",26,1997,0.8,4,2,1,3,0,1,2,50,1,1,0,1,3,7,2,0,"Matches","https://fbref.com/en/comps/9/2023-2024/defense/2023-2024-Premier-League-Stats"
43,"Shandon Baptiste","/en/players/2886c9b5/Shandon-Baptiste","gd GRN","MF","Brentford",25,1998,2.5,4,4,2,2,0,1,5,20,4,5,1,4,3,7,6,0,"Matches","https://fbref.com/en/comps/9/2023-2024/defense/2023-2024-Premier-League-Stats"
44,"Valentín Barco","/en/players/b9f282ec/Valentin-Barco","ar ARG","DF,FW","Brighton",19,2004,3.4,11,5,4,5,2,6,8,75,2,3,0,3,4,15,3,1,"Matches","https://fbref.com/en/comps/9/2023-2024/defense/2023-2024-Premier-League-Stats"
45,"Ross Barkley","/en/players/3a24769f/Ross-Barkley","eng ENG","MF","Luton Town",29,1993,29.1,47,19,16,21,10,11,48,22.9,37,25,9,16,25,72,51,2,"Matches","https://fbref.com/en/comps/9/2023-2024/defense/2023-2024-Premier-League-Stats"
46,"Harvey Barnes","/en/players/3ea50f67/Harvey-Barnes","eng ENG","FW,MF","Newcastle Utd",25,1997,8.9,6,1,3,2,1,1,2,50,1,1,0,1,5,11,3,0,"Matches","https://fbref.com/en/comps/9/2023-2024/defense/2023-2024-Premier-League-Stats"
47,"Chris Basham","/en/players/1aa84968/Chris-Basham","eng ENG","DF,MF","Sheffield Utd",35,1988,3.6,7,2,4,3,0,2,9,22.2,7,9,4,5,5,12,17,0,"Matches","https://fbref.com/en/comps/9/2023-2024/defense/2023-2024-Premier-League-Stats"
48,"Calvin Bassey","/en/players/a36524bf/Calvin-Bassey","ng NGA","DF","Fulham",23,1999,25.6,49,29,33,15,1,21,29,72.4,8,32,11,21,28,77,84,4,"Matches","https://fbref.com/en/comps/9/2023-2024/defense/2023-2024-Premier-League-Stats"
49,"Owen Beck","/en/players/a011a1e9/Owen-Beck","wls WAL","DF","Liverpool",20,2002,0.1,2,1,1,1,0,0,0,NA,0,0,0,0,0,2,1,0,"Matches","https://fbref.com/en/comps/9/2023-2024/defense/2023-2024-Premier-League-Stats"
50,"Donny van de Beek","/en/players/50dc94ce/Donny-van-de-Beek","nl NED","DF","Manchester Utd",26,1997,0,0,0,0,0,0,0,0,NA,0,1,0,1,0,0,0,0,"Matches","https://fbref.com/en/comps/9/2023-2024/defense/2023-2024-Premier-League-Stats"
51,"Amari'i Bell","/en/players/399e9474/Amarii-Bell","jm JAM","DF","Luton Town",29,1994,19.1,50,33,30,19,1,22,35,62.9,13,33,15,18,25,75,60,1,"Matches","https://fbref.com/en/comps/9/2023-2024/defense/2023-2024-Premier-League-Stats"
52,"Jean-Ricner Bellegarde","/en/players/10f0fdd3/Jean-Ricner-Bellegarde","fr FRA","MF,FW","Wolves",25,1998,10.6,17,10,9,6,2,7,15,46.7,8,18,2,16,8,25,14,0,"Matches","https://fbref.com/en/comps/9/2023-2024/defense/2023-2024-Premier-League-Stats"
53,"Anis Ben Slimane","/en/players/9ade9ce1/Anis-Ben-Slimane","tn TUN","MF","Sheffield Utd",22,2001,4.7,11,6,5,2,4,4,10,40,6,7,1,6,5,16,7,0,"Matches","https://fbref.com/en/comps/9/2023-2024/defense/2023-2024-Premier-League-Stats"
54,"Saïd Benrahma","/en/players/5a04fd92/Said-Benrahma","dz ALG","FW,MF","West Ham",27,1995,6.9,8,4,5,3,0,4,15,26.7,11,8,0,8,5,13,7,0,"Matches","https://fbref.com/en/comps/9/2023-2024/defense/2023-2024-Premier-League-Stats"
55,"Rodrigo Bentancur","/en/players/3b8674e6/Rodrigo-Bentancur","uy URU","MF","Tottenham",26,1997,11.2,23,15,10,11,2,10,24,41.7,14,15,4,11,17,40,16,1,"Matches","https://fbref.com/en/comps/9/2023-2024/defense/2023-2024-Premier-League-Stats"
56,"Daniel Bentley","/en/players/68db6358/Daniel-Bentley","eng ENG","GK","Wolves",30,1993,4.3,0,0,0,0,0,0,1,0,1,0,0,0,0,0,1,0,"Matches","https://fbref.com/en/comps/9/2023-2024/defense/2023-2024-Premier-League-Stats"
57,"Jóhann Berg Guðmundsson","/en/players/f72293fc/Johann-Berg-Gudmundsson","is ISL","MF,FW","Burnley",32,1990,13.2,13,4,6,5,2,7,16,43.8,9,14,0,14,16,29,16,0,"Matches","https://fbref.com/en/comps/9/2023-2024/defense/2023-2024-Premier-League-Stats"
58,"Sander Berge","/en/players/d0b6129f/Sander-Berge","no NOR","MF","Burnley",25,1998,33.4,76,46,35,36,5,34,58,58.6,24,49,20,29,23,99,60,2,"Matches","https://fbref.com/en/comps/9/2023-2024/defense/2023-2024-Premier-League-Stats"
59,"Luke Berry","/en/players/2aaadf33/Luke-Berry","eng ENG","MF,DF","Luton Town",31,1992,3.6,7,2,2,4,1,2,3,66.7,1,6,1,5,0,7,3,0,"Matches","https://fbref.com/en/comps/9/2023-2024/defense/2023-2024-Premier-League-Stats"
60,"Beto","/en/players/ed5c0319/Beto","gw GNB","FW","Everton",25,1998,10.6,14,6,1,6,7,4,12,33.3,8,11,0,11,1,15,14,0,"Matches","https://fbref.com/en/comps/9/2023-2024/defense/2023-2024-Premier-League-Stats"
61,"Jordan Beyer","/en/players/9af1f9ff/Jordan-Beyer","de GER","DF","Burnley",23,2000,13.7,35,20,22,12,1,14,24,58.3,10,22,15,7,16,51,68,1,"Matches","https://fbref.com/en/comps/9/2023-2024/defense/2023-2024-Premier-League-Stats"
62,"Philip Billing","/en/players/d328a254/Philip-Billing","dk DEN","MF","Bournemouth",27,1996,15.5,33,16,7,22,4,9,27,33.3,18,31,5,26,20,53,28,1,"Matches","https://fbref.com/en/comps/9/2023-2024/defense/2023-2024-Premier-League-Stats"
63,"Yves Bissouma","/en/players/6c203af0/Yves-Bissouma","ml MLI","MF","Tottenham",26,1996,23,80,52,32,36,12,41,61,67.2,20,28,5,23,37,117,43,3,"Matches","https://fbref.com/en/comps/9/2023-2024/defense/2023-2024-Premier-League-Stats"
64,"Benicio Boaitey","/en/players/4c5835e6/Benicio-Boaitey","eng ENG","FW,DF","Brighton",19,2004,0.4,0,0,0,0,0,0,1,0,1,1,0,1,0,0,2,0,"Matches","https://fbref.com/en/comps/9/2023-2024/defense/2023-2024-Premier-League-Stats"
65,"Oscar Bobb","/en/players/eed2427e/Oscar-Bobb","no NOR","FW,MF","Manchester City",20,2003,3.4,7,3,1,2,4,2,4,50,2,4,0,4,5,12,1,0,"Matches","https://fbref.com/en/comps/9/2023-2024/defense/2023-2024-Premier-League-Stats"
66,"Jayden Bogle","/en/players/ae5019e6/Jayden-Bogle","eng ENG","DF","Sheffield Utd",23,2000,31,66,36,43,21,2,35,70,50,35,42,11,31,32,98,97,0,"Matches","https://fbref.com/en/comps/9/2023-2024/defense/2023-2024-Premier-League-Stats"
67,"Willy Boly","/en/players/a4ac4b8f/Willy-Boly","ci CIV","DF","Nott'ham Forest",32,1991,16,46,29,36,9,1,22,40,55,18,32,21,11,25,71,90,0,"Matches","https://fbref.com/en/comps/9/2023-2024/defense/2023-2024-Premier-League-Stats"
68,"Sven Botman","/en/players/ccce7025/Sven-Botman","nl NED","DF","Newcastle Utd",23,2000,15.3,20,13,14,6,0,8,13,61.5,5,20,16,4,9,29,61,3,"Matches","https://fbref.com/en/comps/9/2023-2024/defense/2023-2024-Premier-League-Stats"
69,"Jarrod Bowen","/en/players/79c84d1c/Jarrod-Bowen","eng ENG","FW","West Ham",26,1996,33.5,42,28,14,14,14,13,35,37.1,22,37,5,32,19,61,14,0,"Matches","https://fbref.com/en/comps/9/2023-2024/defense/2023-2024-Premier-League-Stats"
70,"Conor Bradley","/en/players/bbd67769/Conor-Bradley","nir NIR","DF","Liverpool",20,2003,8.4,33,25,14,12,7,24,38,63.2,14,17,1,16,10,43,14,0,"Matches","https://fbref.com/en/comps/9/2023-2024/defense/2023-2024-Premier-League-Stats"
71,"Jarrad Branthwaite","/en/players/c1949191/Jarrad-Branthwaite","eng ENG","DF","Everton",21,2002,34.6,66,32,42,22,2,45,62,72.6,17,51,36,15,50,116,163,2,"Matches","https://fbref.com/en/comps/9/2023-2024/defense/2023-2024-Premier-League-Stats"
72,"Ben Brereton","/en/players/57827369/Ben-Brereton","cl CHI","FW,MF","Sheffield Utd",24,1999,12.3,9,4,4,4,1,4,10,40,6,9,3,6,3,12,12,0,"Matches","https://fbref.com/en/comps/9/2023-2024/defense/2023-2024-Premier-League-Stats"
73,"Rhian Brewster","/en/players/30e81a88/Rhian-Brewster","eng ENG","FW,MF","Sheffield Utd",23,2000,3.8,5,1,1,2,2,0,2,0,2,2,0,2,1,6,2,0,"Matches","https://fbref.com/en/comps/9/2023-2024/defense/2023-2024-Premier-League-Stats"
74,"Armando Broja","/en/players/97220da2/Armando-Broja","al ALB","FW","Chelsea",21,2001,5,3,0,0,1,2,1,2,50,1,5,1,4,0,3,3,0,"Matches","https://fbref.com/en/comps/9/2023-2024/defense/2023-2024-Premier-League-Stats"
75,"Armando Broja","/en/players/97220da2/Armando-Broja","al ALB","FW","Fulham",21,2001,1,0,0,0,0,0,0,0,NA,0,1,0,1,0,0,0,0,"Matches","https://fbref.com/en/comps/9/2023-2024/defense/2023-2024-Premier-League-Stats"
76,"Andre Brooks","/en/players/5f346071/Andre-Brooks","eng ENG","MF,DF","Sheffield Utd",19,2003,10.4,22,13,7,11,4,9,21,42.9,12,13,1,12,14,36,20,0,"Matches","https://fbref.com/en/comps/9/2023-2024/defense/2023-2024-Premier-League-Stats"
77,"David Brooks","/en/players/dc4cae05/David-Brooks","wls WAL","FW,MF","Bournemouth",26,1997,3.1,5,4,2,1,2,2,4,50,2,3,0,3,2,7,2,0,"Matches","https://fbref.com/en/comps/9/2023-2024/defense/2023-2024-Premier-League-Stats"
78,"Jacob Brown","/en/players/ca18c8f1/Jacob-Brown","sct SCO","MF,FW","Luton Town",25,1998,11.3,19,12,7,7,5,7,18,38.9,11,20,1,19,8,27,22,0,"Matches","https://fbref.com/en/comps/9/2023-2024/defense/2023-2024-Premier-League-Stats"
79,"Josh Brownhill","/en/players/47369df8/Josh-Brownhill","eng ENG","MF","Burnley",27,1995,25,61,35,23,28,10,27,37,73,10,33,8,25,34,95,40,1,"Matches","https://fbref.com/en/comps/9/2023-2024/defense/2023-2024-Premier-League-Stats"
80,"Jacob Bruun Larsen","/en/players/4e204552/Jacob-Bruun-Larsen","dk DEN","MF,FW","Burnley",24,1998,13.9,9,4,4,3,2,7,21,33.3,14,16,2,14,7,16,23,0,"Matches","https://fbref.com/en/comps/9/2023-2024/defense/2023-2024-Premier-League-Stats"
81,"Hugo Bueno","/en/players/bfc3b3a0/Hugo-Bueno","es ESP","DF,MF","Wolves",20,2002,8.2,21,14,12,7,2,12,19,63.2,7,17,4,13,6,27,24,0,"Matches","https://fbref.com/en/comps/9/2023-2024/defense/2023-2024-Premier-League-Stats"
82,"Santiago Bueno","/en/players/edc98fac/Santiago-Bueno","uy URU","DF","Wolves",24,1998,9.1,13,7,5,7,1,5,11,45.5,6,22,12,10,6,19,33,0,"Matches","https://fbref.com/en/comps/9/2023-2024/defense/2023-2024-Premier-League-Stats"
83,"Facundo Buonanotte","/en/players/468a7a91/Facundo-Buonanotte","ar ARG","FW,MF","Brighton",18,2004,15.2,42,22,13,22,7,14,44,31.8,30,22,3,19,8,50,5,0,"Matches","https://fbref.com/en/comps/9/2023-2024/defense/2023-2024-Premier-League-Stats"
84,"Reece Burke","/en/players/a681b7b7/Reece-Burke","eng ENG","DF","Luton Town",26,1996,18.4,37,23,17,14,6,12,26,46.2,14,25,18,7,18,55,78,1,"Matches","https://fbref.com/en/comps/9/2023-2024/defense/2023-2024-Premier-League-Stats"
85,"Dan Burn","/en/players/b2d31e83/Dan-Burn","eng ENG","DF","Newcastle Utd",31,1992,30.3,61,33,37,20,4,26,61,42.6,35,55,25,30,37,98,124,1,"Matches","https://fbref.com/en/comps/9/2023-2024/defense/2023-2024-Premier-League-Stats"
86,"Mason Burstow","/en/players/dab84ad2/Mason-Burstow","eng ENG","FW","Chelsea",19,2003,0.1,0,0,0,0,0,0,0,NA,0,0,0,0,0,0,0,0,"Matches","https://fbref.com/en/comps/9/2023-2024/defense/2023-2024-Premier-League-Stats"
87,"Moisés Caicedo","/en/players/16264a81/Moises-Caicedo","ec ECU","MF","Chelsea",21,2001,31.8,91,46,38,42,11,36,60,60,24,59,25,34,37,128,44,4,"Matches","https://fbref.com/en/comps/9/2023-2024/defense/2023-2024-Premier-League-Stats"
88,"Tom Cairney","/en/players/a8748947/Tom-Cairney","sct SCO","MF","Fulham",32,1991,16.5,24,16,10,12,2,13,25,52,12,16,4,12,13,37,6,0,"Matches","https://fbref.com/en/comps/9/2023-2024/defense/2023-2024-Premier-League-Stats"
89,"Dominic Calvert-Lewin","/en/players/59e6e5bf/Dominic-Calvert-Lewin","eng ENG","FW","Everton",26,1997,24.1,13,6,2,6,5,2,15,13.3,13,14,4,10,4,17,38,0,"Matches","https://fbref.com/en/comps/9/2023-2024/defense/2023-2024-Premier-League-Stats"
90,"Thomas Cannon","/en/players/4506aec5/Thomas-Cannon","ie IRL","FW","Everton",20,2002,0,0,0,0,0,0,0,0,NA,0,0,0,0,0,0,0,0,"Matches","https://fbref.com/en/comps/9/2023-2024/defense/2023-2024-Premier-League-Stats"
91,"Diego Carlos","/en/players/b4a014b1/Diego-Carlos","br BRA","DF","Aston Villa",30,1993,20.2,27,16,22,4,1,13,21,61.9,8,24,19,5,13,40,78,3,"Matches","https://fbref.com/en/comps/9/2023-2024/defense/2023-2024-Premier-League-Stats"
92,"Cesare Casadei","/en/players/fb920f3a/Cesare-Casadei","it ITA","FW,MF","Chelsea",20,2003,0.9,5,3,2,1,2,2,5,40,3,1,0,1,0,5,4,0,"Matches","https://fbref.com/en/comps/9/2023-2024/defense/2023-2024-Premier-League-Stats"
93,"Casemiro","/en/players/4d224fe8/Casemiro","br BRA","MF,DF","Manchester Utd",31,1992,22,83,56,43,32,8,51,106,48.1,55,74,33,41,18,101,71,1,"Matches","https://fbref.com/en/comps/9/2023-2024/defense/2023-2024-Premier-League-Stats"
94,"Kaelan Casey","/en/players/cd4b2c5f/Kaelan-Casey","eng ENG","DF","West Ham",18,2004,0,0,0,0,0,0,0,0,NA,0,0,0,0,0,0,1,0,"Matches","https://fbref.com/en/comps/9/2023-2024/defense/2023-2024-Premier-League-Stats"
95,"Matty Cash","/en/players/2389cdc2/Matty-Cash","pl POL","DF","Aston Villa",25,1997,23.8,54,31,24,24,6,29,59,49.2,30,35,14,21,18,72,59,0,"Matches","https://fbref.com/en/comps/9/2023-2024/defense/2023-2024-Premier-League-Stats"
96,"Timothy Castagne","/en/players/197640fd/Timothy-Castagne","be BEL","DF","Fulham",27,1995,29.3,49,24,23,16,10,26,44,59.1,18,38,10,28,38,87,69,1,"Matches","https://fbref.com/en/comps/9/2023-2024/defense/2023-2024-Premier-League-Stats"
97,"Jonny Castro","/en/players/e28868f3/Jonny-Castro","es ESP","MF","Wolves",29,1994,0.1,0,0,0,0,0,0,1,0,1,1,1,0,0,0,0,0,"Matches","https://fbref.com/en/comps/9/2023-2024/defense/2023-2024-Premier-League-Stats"
98,"Trevoh Chalobah","/en/players/5515376c/Trevoh-Chalobah","eng ENG","DF","Chelsea",24,1999,10.6,16,12,10,2,4,10,15,66.7,5,8,7,1,8,24,51,0,"Matches","https://fbref.com/en/comps/9/2023-2024/defense/2023-2024-Premier-League-Stats"
99,"Calum Chambers","/en/players/dc6f5bdd/Calum-Chambers","eng ENG","MF,DF","Aston Villa",28,1995,1.7,3,0,3,0,0,0,1,0,1,2,1,1,2,5,4,0,"Matches","https://fbref.com/en/comps/9/2023-2024/defense/2023-2024-Premier-League-Stats"
100,"Youssef Chermiti","/en/players/890f108d/Youssef-Chermiti","pt POR","FW","Everton",19,2004,2.3,3,2,2,1,0,1,5,20,4,4,1,3,1,4,2,0,"Matches","https://fbref.com/en/comps/9/2023-2024/defense/2023-2024-Premier-League-Stats"
101,"Ben Chilwell","/en/players/d2424d1b/Ben-Chilwell","eng ENG","DF","Chelsea",26,1996,8.4,15,10,5,9,1,5,8,62.5,3,11,3,8,4,19,19,1,"Matches","https://fbref.com/en/comps/9/2023-2024/defense/2023-2024-Premier-League-Stats"
102,"Tawanda Chirewa","/en/players/34721c11/Tawanda-Chirewa","zw ZIM","MF,FW","Wolves",19,2003,1.6,7,3,3,3,1,2,3,66.7,1,0,0,0,1,8,0,0,"Matches","https://fbref.com/en/comps/9/2023-2024/defense/2023-2024-Premier-League-Stats"
103,"Leon Chiwome","/en/players/a2852b4f/Leon-Chiwome","eng ENG","FW","Wolves",17,2006,1.9,2,1,0,1,1,1,2,50,1,3,1,2,0,2,2,0,"Matches","https://fbref.com/en/comps/9/2023-2024/defense/2023-2024-Premier-League-Stats"
104,"Tahith Chong","/en/players/2696b6a9/Tahith-Chong","nl NED","MF,FW","Luton Town",23,1999,22,36,22,19,13,4,15,33,45.5,18,30,6,24,8,44,11,1,"Matches","https://fbref.com/en/comps/9/2023-2024/defense/2023-2024-Premier-League-Stats"
105,"Ryan Christie","/en/players/26ce2263/Ryan-Christie","sct SCO","MF","Bournemouth",28,1995,32.3,86,44,34,35,17,39,92,42.4,53,52,11,41,52,138,53,1,"Matches","https://fbref.com/en/comps/9/2023-2024/defense/2023-2024-Premier-League-Stats"
106,"Carney Chukwuemeka","/en/players/b2f9c73e/Carney-Chukwuemeka","eng ENG","MF,FW","Chelsea",19,2003,2.5,6,4,3,3,0,1,3,33.3,2,1,1,0,0,6,1,0,"Matches","https://fbref.com/en/comps/9/2023-2024/defense/2023-2024-Premier-League-Stats"
107,"Bobby Clark","/en/players/73341ace/Bobby-Clark","eng ENG","MF","Liverpool",18,2005,1,2,1,1,1,0,1,5,20,4,6,2,4,1,3,1,0,"Matches","https://fbref.com/en/comps/9/2023-2024/defense/2023-2024-Premier-League-Stats"
108,"Jordan Clark","/en/players/7c5fa6cf/Jordan-Clark","eng ENG","MF","Luton Town",29,1993,14.5,30,17,14,11,5,11,39,28.2,28,24,3,21,11,41,15,1,"Matches","https://fbref.com/en/comps/9/2023-2024/defense/2023-2024-Premier-League-Stats"
109,"Nathaniel Clyne","/en/players/0442183b/Nathaniel-Clyne","eng ENG","DF","Crystal Palace",32,1991,14.9,24,15,11,11,2,14,21,66.7,7,18,6,12,10,34,33,0,"Matches","https://fbref.com/en/comps/9/2023-2024/defense/2023-2024-Premier-League-Stats"
110,"Séamus Coleman","/en/players/0420d84f/Seamus-Coleman","ie IRL","DF","Everton",34,1988,7.4,17,14,10,3,4,11,16,68.8,5,12,4,8,7,24,26,1,"Matches","https://fbref.com/en/comps/9/2023-2024/defense/2023-2024-Premier-League-Stats"
111,"Nathan Collins","/en/players/a8c19eb8/Nathan-Collins","ie IRL","DF","Brentford",22,2001,29.5,38,20,24,12,2,19,29,65.5,10,46,30,16,44,82,141,4,"Matches","https://fbref.com/en/comps/9/2023-2024/defense/2023-2024-Premier-League-Stats"
112,"Levi Colwill","/en/players/700783e7/Levi-Colwill","eng ENG","DF","Chelsea",20,2003,20,48,30,26,17,5,26,34,76.5,8,28,10,18,26,74,66,0,"Matches","https://fbref.com/en/comps/9/2023-2024/defense/2023-2024-Premier-League-Stats"
113,"Lewis Cook","/en/players/2afc7272/Lewis-Cook","eng ENG","MF","Bournemouth",26,1997,31,61,41,24,30,7,34,63,54,29,32,11,21,65,126,46,1,"Matches","https://fbref.com/en/comps/9/2023-2024/defense/2023-2024-Premier-League-Stats"
114,"Jack Cork","/en/players/74e12f1e/Jack-Cork","eng ENG","MF","Burnley",34,1989,0.3,2,0,0,2,0,1,3,33.3,2,0,0,0,1,3,1,0,"Matches","https://fbref.com/en/comps/9/2023-2024/defense/2023-2024-Premier-League-Stats"
115,"Maxwel Cornet","/en/players/beb391dd/Maxwel-Cornet","ci CIV","MF,FW","West Ham",26,1996,1.2,3,2,3,0,0,1,5,20,4,2,0,2,2,5,1,0,"Matches","https://fbref.com/en/comps/9/2023-2024/defense/2023-2024-Premier-League-Stats"
116,"Vladimír Coufal","/en/players/fdf3cb77/Vladimir-Coufal","cz CZE","DF","West Ham",30,1992,34.8,64,41,50,12,2,38,75,50.7,37,49,15,34,43,107,97,0,"Matches","https://fbref.com/en/comps/9/2023-2024/defense/2023-2024-Premier-League-Stats"
117,"Philippe Coutinho","/en/players/0ef89a37/Philippe-Coutinho","br BRA","MF,FW","Aston Villa",31,1992,0.3,0,0,0,0,0,0,1,0,1,0,0,0,0,0,0,0,"Matches","https://fbref.com/en/comps/9/2023-2024/defense/2023-2024-Premier-League-Stats"
118,"Aaron Cresswell","/en/players/4f974391/Aaron-Cresswell","eng ENG","DF,FW","West Ham",33,1989,4.8,3,2,1,1,1,2,3,66.7,1,5,3,2,3,6,7,0,"Matches","https://fbref.com/en/comps/9/2023-2024/defense/2023-2024-Premier-League-Stats"
119,"Marc Cucurella","/en/players/1daec722/Marc-Cucurella","es ESP","DF","Chelsea",25,1998,19.8,62,38,36,21,5,34,64,53.1,30,36,13,23,22,84,48,0,"Matches","https://fbref.com/en/comps/9/2023-2024/defense/2023-2024-Premier-League-Stats"
120,"Josh Cullen","/en/players/f6d7d690/Josh-Cullen","ie IRL","MF","Burnley",27,1996,22.9,42,29,15,22,5,26,46,56.5,20,31,19,12,15,57,26,1,"Matches","https://fbref.com/en/comps/9/2023-2024/defense/2023-2024-Premier-League-Stats"
121,"Matheus Cunha","/en/players/dc62b55d/Matheus-Cunha","br BRA","FW,MF","Wolves",24,1999,27.1,30,16,8,17,5,13,35,37.1,22,28,7,21,13,43,21,1,"Matches","https://fbref.com/en/comps/9/2023-2024/defense/2023-2024-Premier-League-Stats"
122,"Sam Curtis","/en/players/7d42865e/Sam-Curtis","ie IRL","DF","Sheffield Utd",17,2005,0.3,1,0,1,0,0,1,2,50,1,2,0,2,0,1,0,0,"Matches","https://fbref.com/en/comps/9/2023-2024/defense/2023-2024-Premier-League-Stats"
123,"Mahmoud Dahoud","/en/players/db4ed67b/Mahmoud-Dahoud","de GER","MF","Brighton",27,1996,5,9,4,2,4,3,3,9,33.3,6,4,1,3,1,10,5,0,"Matches","https://fbref.com/en/comps/9/2023-2024/defense/2023-2024-Premier-League-Stats"
124,"Ameen Al-Dakhil","/en/players/93e08bce/Ameen-Al-Dakhil","be BEL","DF","Burnley",21,2002,11.7,12,5,4,7,1,1,10,10,9,13,6,7,12,24,38,2,"Matches","https://fbref.com/en/comps/9/2023-2024/defense/2023-2024-Premier-League-Stats"
125,"Diogo Dalot","/en/players/d9565625/Diogo-Dalot","pt POR","DF","Manchester Utd",24,1999,35.3,81,51,58,12,11,51,74,68.9,23,44,16,28,37,118,111,0,"Matches","https://fbref.com/en/comps/9/2023-2024/defense/2023-2024-Premier-League-Stats"
126,"Mikkel Damsgaard","/en/players/215f3907/Mikkel-Damsgaard","dk DEN","MF","Brentford",23,2000,9.4,29,17,13,9,7,14,40,35,26,23,1,22,11,40,10,1,"Matches","https://fbref.com/en/comps/9/2023-2024/defense/2023-2024-Premier-League-Stats"
127,"Danilo","/en/players/a816dbfb/Danilo","br BRA","MF","Nott'ham Forest",22,2001,19.9,36,18,22,12,2,21,46,45.7,25,34,8,26,35,71,42,0,"Matches","https://fbref.com/en/comps/9/2023-2024/defense/2023-2024-Premier-League-Stats"
128,"Arnaut Danjuma","/en/players/f08490a6/Arnaut-Danjuma","nl NED","MF,FW","Everton",26,1997,6.6,6,4,2,3,1,1,4,25,3,4,0,4,3,9,0,0,"Matches","https://fbref.com/en/comps/9/2023-2024/defense/2023-2024-Premier-League-Stats"
129,"Jayden Danns","/en/players/003cf4d1/Jayden-Danns","eng ENG","FW","Liverpool",17,2006,0.1,0,0,0,0,0,0,0,NA,0,0,0,0,0,0,0,0,"Matches","https://fbref.com/en/comps/9/2023-2024/defense/2023-2024-Premier-League-Stats"
130,"Josh Dasilva","/en/players/60344e4f/Josh-Dasilva","eng ENG","DF,FW","Brentford",24,1998,0.3,2,1,0,1,1,0,0,NA,0,0,0,0,0,2,0,0,"Matches","https://fbref.com/en/comps/9/2023-2024/defense/2023-2024-Premier-League-Stats"
131,"David Datro Fofana","/en/players/e82900ef/David-Datro-Fofana","ci CIV","FW","Burnley",20,2002,9.8,10,5,3,5,2,3,6,50,3,9,3,6,1,11,2,0,"Matches","https://fbref.com/en/comps/9/2023-2024/defense/2023-2024-Premier-League-Stats"
132,"Ben Davies","/en/players/44781702/Ben-Davies","wls WAL","DF","Tottenham",30,1993,12.1,24,17,13,8,3,16,21,76.2,5,17,15,2,10,34,35,0,"Matches","https://fbref.com/en/comps/9/2023-2024/defense/2023-2024-Premier-League-Stats"
133,"Tom Davies","/en/players/9228b07c/Tom-Davies","eng ENG","MF","Sheffield Utd",25,1998,2.5,10,5,4,3,3,3,9,33.3,6,2,1,1,3,13,6,1,"Matches","https://fbref.com/en/comps/9/2023-2024/defense/2023-2024-Premier-League-Stats"
134,"Craig Dawson","/en/players/3e9e06cb/Craig-Dawson","eng ENG","DF","Wolves",33,1990,24.5,30,20,23,6,1,22,34,64.7,12,51,39,12,16,46,120,1,"Matches","https://fbref.com/en/comps/9/2023-2024/defense/2023-2024-Premier-League-Stats"
135,"Kevin De Bruyne","/en/players/e46012d4/Kevin-De-Bruyne","be BEL","MF","Manchester City",32,1991,13.6,14,9,1,5,8,7,20,35,13,5,0,5,4,18,4,0,"Matches","https://fbref.com/en/comps/9/2023-2024/defense/2023-2024-Premier-League-Stats"
136,"Hannes Delcroix","/en/players/b737f944/Hannes-Delcroix","be BEL","DF","Burnley",24,1999,6.5,10,6,6,4,0,3,4,75,1,9,3,6,9,19,26,0,"Matches","https://fbref.com/en/comps/9/2023-2024/defense/2023-2024-Premier-League-Stats"
137,"Leander Dendoncker","/en/players/5a7301ae/Leander-Dendoncker","be BEL","MF","Aston Villa",28,1995,1.3,6,4,3,2,1,4,5,80,1,5,2,3,2,8,3,1,"Matches","https://fbref.com/en/comps/9/2023-2024/defense/2023-2024-Premier-League-Stats"
138,"Moussa Diaby","/en/players/aeed5c06/Moussa-Diaby","fr FRA","FW,MF","Aston Villa",24,1999,24.2,12,5,5,4,3,4,22,18.2,18,8,1,7,9,21,6,0,"Matches","https://fbref.com/en/comps/9/2023-2024/defense/2023-2024-Premier-League-Stats"
139,"Amad Diallo","/en/players/9dc96f10/Amad-Diallo","ci CIV","FW,MF","Manchester Utd",21,2002,4.3,10,3,1,6,3,3,7,42.9,4,3,1,2,1,11,6,0,"Matches","https://fbref.com/en/comps/9/2023-2024/defense/2023-2024-Premier-League-Stats"
140,"Amadou Diallo","/en/players/e31708b2/Amadou-Diallo","eng ENG","MF","Newcastle Utd",20,2003,0,0,0,0,0,0,0,0,NA,0,0,0,0,0,0,0,0,"Matches","https://fbref.com/en/comps/9/2023-2024/defense/2023-2024-Premier-League-Stats"
141,"Rúben Dias","/en/players/31c69ef1/Ruben-Dias","pt POR","DF","Manchester City",26,1997,28.4,39,20,14,21,4,19,26,73.1,7,32,17,15,30,69,77,0,"Matches","https://fbref.com/en/comps/9/2023-2024/defense/2023-2024-Premier-League-Stats"
142,"Luis Díaz","/en/players/4a1a9578/Luis-Diaz","co COL","FW","Liverpool",26,1997,29.2,35,25,5,17,13,7,30,23.3,23,15,0,15,3,38,8,0,"Matches","https://fbref.com/en/comps/9/2023-2024/defense/2023-2024-Premier-League-Stats"
143,"Eric Dier","/en/players/ac861941/Eric-Dier","eng ENG","DF","Tottenham",29,1994,2.2,2,1,2,0,0,2,2,100,0,3,3,0,2,4,12,0,"Matches","https://fbref.com/en/comps/9/2023-2024/defense/2023-2024-Premier-League-Stats"
144,"Lucas Digne","/en/players/1b84dbe1/Lucas-Digne","fr FRA","DF","Aston Villa",30,1993,26.8,47,19,35,9,3,25,44,56.8,19,20,2,18,26,73,67,0,"Matches","https://fbref.com/en/comps/9/2023-2024/defense/2023-2024-Premier-League-Stats"
145,"Issa Diop","/en/players/a712ca2b/Issa-Diop","fr FRA","DF","Fulham",26,1997,15.8,30,16,23,5,2,15,20,75,5,28,19,9,17,47,80,1,"Matches","https://fbref.com/en/comps/9/2023-2024/defense/2023-2024-Premier-League-Stats"
146,"Axel Disasi","/en/players/ad82197c/Axel-Disasi","fr FRA","DF","Chelsea",25,1998,28.7,33,19,20,10,3,23,30,76.7,7,26,19,7,18,51,102,2,"Matches","https://fbref.com/en/comps/9/2023-2024/defense/2023-2024-Premier-League-Stats"
147,"Ben Doak","/en/players/733f1a7d/Ben-Doak","sct SCO","FW","Liverpool",17,2005,0.2,0,0,0,0,0,0,0,NA,0,0,0,0,0,0,0,0,"Matches","https://fbref.com/en/comps/9/2023-2024/defense/2023-2024-Premier-League-Stats"
148,"Lewis Dobbin","/en/players/e814e1cf/Lewis-Dobbin","eng ENG","MF","Everton",20,2003,2.6,9,7,3,5,1,5,9,55.6,4,5,1,4,1,10,0,0,"Matches","https://fbref.com/en/comps/9/2023-2024/defense/2023-2024-Premier-League-Stats"
149,"Matt Doherty","/en/players/d557d734/Matt-Doherty","ie IRL","DF,MF","Wolves",31,1992,12.8,31,18,17,10,4,12,23,52.2,11,15,5,10,7,38,47,0,"Matches","https://fbref.com/en/comps/9/2023-2024/defense/2023-2024-Premier-League-Stats"
150,"Jeremy Doku","/en/players/fffea3e5/Jeremy-Doku","be BEL","FW,MF","Manchester City",21,2002,17.7,39,22,13,12,14,9,20,45,11,14,0,14,9,48,5,0,"Matches","https://fbref.com/en/comps/9/2023-2024/defense/2023-2024-Premier-League-Stats"
151,"Nicolás Domínguez","/en/players/20b3a502/Nicolas-Dominguez","ar ARG","MF,FW","Nott'ham Forest",25,1998,16.6,63,34,35,27,1,23,48,47.9,25,31,5,26,18,81,24,0,"Matches","https://fbref.com/en/comps/9/2023-2024/defense/2023-2024-Premier-League-Stats"
152,"Jamie Donley","/en/players/5e4d9b48/Jamie-Donley","nir NIR","FW","Tottenham",18,2005,0,0,0,0,0,0,0,0,NA,0,0,0,0,0,0,3,0,"Matches","https://fbref.com/en/comps/9/2023-2024/defense/2023-2024-Premier-League-Stats"
153,"Abdoulaye Doucouré","/en/players/02b29014/Abdoulaye-Doucoure","ml MLI","FW,MF","Everton",30,1993,29.2,43,27,20,14,9,18,46,39.1,28,23,3,20,15,58,19,0,"Matches","https://fbref.com/en/comps/9/2023-2024/defense/2023-2024-Premier-League-Stats"
154,"Cheick Doucouré","/en/players/ce4f40c7/Cheick-Doucoure","ml MLI","MF","Crystal Palace",23,2000,10.2,34,17,15,13,6,18,30,60,12,13,2,11,20,54,12,0,"Matches","https://fbref.com/en/comps/9/2023-2024/defense/2023-2024-Premier-League-Stats"
155,"Alfie Doughty","/en/players/bf33b257/Alfie-Doughty","eng ENG","DF","Luton Town",23,1999,32.5,63,40,29,18,16,37,82,45.1,45,51,9,42,31,94,43,4,"Matches","https://fbref.com/en/comps/9/2023-2024/defense/2023-2024-Premier-League-Stats"
156,"Tommy Doyle","/en/players/5526deb1/Tommy-Doyle","eng ENG","MF","Wolves",21,2001,13.6,26,13,11,10,5,14,23,60.9,9,22,9,13,12,38,18,0,"Matches","https://fbref.com/en/comps/9/2023-2024/defense/2023-2024-Premier-League-Stats"
157,"Radu Drăgușin","/en/players/620922ed/Radu-Dragusin","ro ROU","DF","Tottenham",21,2002,4.8,5,3,5,0,0,3,3,100,0,5,4,1,8,13,19,0,"Matches","https://fbref.com/en/comps/9/2023-2024/defense/2023-2024-Premier-League-Stats"
158,"Martin Dúbravka","/en/players/3a949a25/Martin-Dubravka","sk SVK","GK","Newcastle Utd",34,1989,22.1,0,0,0,0,0,0,4,0,4,0,0,0,0,0,8,1,"Matches","https://fbref.com/en/comps/9/2023-2024/defense/2023-2024-Premier-League-Stats"
159,"Paul Dummett","/en/players/3fe6bd8c/Paul-Dummett","wls WAL","DF","Newcastle Utd",31,1991,0.2,1,0,1,0,0,1,1,100,0,0,0,0,0,1,1,0,"Matches","https://fbref.com/en/comps/9/2023-2024/defense/2023-2024-Premier-League-Stats"
160,"Lewis Dunk","/en/players/282f75f3/Lewis-Dunk","eng ENG","DF","Brighton",31,1991,31.9,27,14,17,9,1,13,36,36.1,23,49,37,12,31,58,90,1,"Matches","https://fbref.com/en/comps/9/2023-2024/defense/2023-2024-Premier-League-Stats"
161,"Jáder Durán","/en/players/414184f7/Jader-Duran","co COL","FW,MF","Aston Villa",19,2003,5.3,6,5,3,1,2,1,6,16.7,5,6,0,6,1,7,10,0,"Matches","https://fbref.com/en/comps/9/2023-2024/defense/2023-2024-Premier-League-Stats"
162,"George Earthy","/en/players/123d2733/George-Earthy","eng ENG","FW","West Ham",18,2004,0.4,0,0,0,0,0,0,1,0,1,0,0,0,1,1,0,0,"Matches","https://fbref.com/en/comps/9/2023-2024/defense/2023-2024-Premier-League-Stats"
163,"Ederson","/en/players/3bb7b8b4/Ederson","br BRA","GK","Manchester City",29,1993,30.9,0,0,0,0,0,0,1,0,1,0,0,0,0,0,10,1,"Matches","https://fbref.com/en/comps/9/2023-2024/defense/2023-2024-Premier-League-Stats"
164,"Odsonne Édouard","/en/players/0562b7f1/Odsonne-Edouard","fr FRA","FW,MF","Crystal Palace",25,1998,17.3,24,12,8,8,8,4,19,21.1,15,17,1,16,6,30,19,0,"Matches","https://fbref.com/en/comps/9/2023-2024/defense/2023-2024-Premier-League-Stats"
165,"John Egan","/en/players/debe38a0/John-Egan","ie IRL","DF","Sheffield Utd",30,1992,5.4,6,4,4,2,0,4,11,36.4,7,10,4,6,13,19,39,1,"Matches","https://fbref.com/en/comps/9/2023-2024/defense/2023-2024-Premier-League-Stats"
166,"Hjalmar Ekdal","/en/players/3d554589/Hjalmar-Ekdal","se SWE","DF","Burnley",24,1998,4.9,4,2,2,2,0,2,4,50,2,10,5,5,6,10,21,0,"Matches","https://fbref.com/en/comps/9/2023-2024/defense/2023-2024-Premier-League-Stats"
167,"Anthony Elanga","/en/players/2fba6108/Anthony-Elanga","se SWE","FW,MF","Nott'ham Forest",21,2002,27,33,19,20,6,7,17,37,45.9,20,22,2,20,8,41,20,1,"Matches","https://fbref.com/en/comps/9/2023-2024/defense/2023-2024-Premier-League-Stats"
168,"Harvey Elliott","/en/players/b9e1436c/Harvey-Elliott","eng ENG","MF,FW","Liverpool",20,2003,15,27,17,8,14,5,10,31,32.3,21,27,0,27,6,33,7,0,"Matches","https://fbref.com/en/comps/9/2023-2024/defense/2023-2024-Premier-League-Stats"
169,"Mohamed Elneny","/en/players/47a34c4f/Mohamed-Elneny","eg EGY","MF","Arsenal",31,1992,0.3,0,0,0,0,0,0,1,0,1,0,0,0,1,1,0,0,"Matches","https://fbref.com/en/comps/9/2023-2024/defense/2023-2024-Premier-League-Stats"
170,"Emerson","/en/players/df8b52a5/Emerson","br BRA","DF","Tottenham",24,1999,12.9,36,24,23,10,3,21,43,48.8,22,23,10,13,20,56,50,1,"Matches","https://fbref.com/en/comps/9/2023-2024/defense/2023-2024-Premier-League-Stats"
171,"Julio Enciso","/en/players/9cfbad36/Julio-Enciso","py PAR","MF,FW","Brighton",19,2004,5.3,6,2,3,2,1,2,7,28.6,5,11,0,11,0,6,3,0,"Matches","https://fbref.com/en/comps/9/2023-2024/defense/2023-2024-Premier-League-Stats"
172,"Wataru Endo","/en/players/c149016b/Wataru-Endo","jp JPN","MF","Liverpool",30,1993,19.1,48,28,11,31,6,20,61,32.8,41,24,2,22,20,68,31,3,"Matches","https://fbref.com/en/comps/9/2023-2024/defense/2023-2024-Premier-League-Stats"
173,"Christian Eriksen","/en/players/980522ec/Christian-Eriksen","dk DEN","MF","Manchester Utd",31,1992,12.7,18,13,5,10,3,12,33,36.4,21,17,6,11,4,22,13,0,"Matches","https://fbref.com/en/comps/9/2023-2024/defense/2023-2024-Premier-League-Stats"
174,"Maxime Estève","/en/players/1a066e69/Maxime-Esteve","fr FRA","DF","Burnley",21,2002,14.5,27,10,15,12,0,18,32,56.3,14,21,10,11,27,54,56,0,"Matches","https://fbref.com/en/comps/9/2023-2024/defense/2023-2024-Premier-League-Stats"
175,"Pervis Estupiñán","/en/players/d38fdf53/Pervis-Estupinan","ec ECU","DF","Brighton",25,1998,13.8,26,13,12,11,3,14,30,46.7,16,14,4,10,21,47,20,0,"Matches","https://fbref.com/en/comps/9/2023-2024/defense/2023-2024-Premier-League-Stats"
176,"Jonny Evans","/en/players/f8fcd2a5/Jonny-Evans","nir NIR","DF","Manchester Utd",35,1988,15.5,22,14,20,2,0,12,21,57.1,9,25,18,7,23,45,76,0,"Matches","https://fbref.com/en/comps/9/2023-2024/defense/2023-2024-Premier-League-Stats"
177,"Eberechi Eze","/en/players/ae4fc6a4/Eberechi-Eze","eng ENG","MF,FW","Crystal Palace",25,1998,22.8,35,17,4,18,13,15,31,48.4,16,27,2,25,11,46,6,0,"Matches","https://fbref.com/en/comps/9/2023-2024/defense/2023-2024-Premier-League-Stats"
178,"Łukasz Fabiański","/en/players/9328b835/Lukasz-Fabianski","pl POL","GK","West Ham",38,1985,8,1,0,1,0,0,1,2,50,1,0,0,0,1,2,4,0,"Matches","https://fbref.com/en/comps/9/2023-2024/defense/2023-2024-Premier-League-Stats"
179,"Romain Faivre","/en/players/745ca0a3/Romain-Faivre","fr FRA","MF,FW","Bournemouth",25,1998,0.5,1,1,0,1,0,0,3,0,3,0,0,0,0,1,0,0,"Matches","https://fbref.com/en/comps/9/2023-2024/defense/2023-2024-Premier-League-Stats"
180,"Ansu Fati","/en/players/0ba976e4/Ansu-Fati","es ESP","MF,FW","Brighton",20,2002,5.8,5,3,1,2,2,1,11,9.1,10,8,0,8,3,8,3,0,"Matches","https://fbref.com/en/comps/9/2023-2024/defense/2023-2024-Premier-League-Stats"
181,"Felipe","/en/players/51a3c4c8/Felipe","br BRA","DF","Nott'ham Forest",34,1989,4.2,12,9,9,3,0,9,12,75,3,4,1,3,4,16,12,0,"Matches","https://fbref.com/en/comps/9/2023-2024/defense/2023-2024-Premier-League-Stats"
182,"Evan Ferguson","/en/players/4596da74/Evan-Ferguson","ie IRL","FW","Brighton",18,2004,15.2,14,6,4,7,3,5,14,35.7,9,10,3,7,2,16,8,0,"Matches","https://fbref.com/en/comps/9/2023-2024/defense/2023-2024-Premier-League-Stats"
183,"Bruno Fernandes","/en/players/507c7bdf/Bruno-Fernandes","pt POR","MF,FW","Manchester Utd",28,1994,34.6,68,38,27,25,16,30,88,34.1,58,49,6,43,27,95,50,2,"Matches","https://fbref.com/en/comps/9/2023-2024/defense/2023-2024-Premier-League-Stats"
184,"Enzo Fernández","/en/players/5ff4ab71/Enzo-Fernandez","ar ARG","MF","Chelsea",22,2001,24.5,50,22,22,18,10,27,65,41.5,38,36,13,23,17,67,28,0,"Matches","https://fbref.com/en/comps/9/2023-2024/defense/2023-2024-Premier-League-Stats"
185,"John Fleck","/en/players/b63e789d/John-Fleck","sct SCO","MF,DF","Sheffield Utd",31,1991,1,1,0,0,1,0,0,1,0,1,0,0,0,0,1,1,0,"Matches","https://fbref.com/en/comps/9/2023-2024/defense/2023-2024-Premier-League-Stats"
186,"Mark Flekken","/en/players/a92ab7be/Mark-Flekken","nl NED","GK","Brentford",30,1993,36.5,1,1,1,0,0,1,5,20,4,1,0,1,0,1,17,1,"Matches","https://fbref.com/en/comps/9/2023-2024/defense/2023-2024-Premier-League-Stats"
187,"Phil Foden","/en/players/ed1e53f3/Phil-Foden","eng ENG","FW,MF","Manchester City",23,2000,31.7,31,20,11,10,10,13,31,41.9,18,30,0,30,13,44,18,1,"Matches","https://fbref.com/en/comps/9/2023-2024/defense/2023-2024-Premier-League-Stats"
188,"Wes Foderingham","/en/players/96cf7b61/Wes-Foderingham","eng ENG","GK","Sheffield Utd",32,1991,29.4,5,3,5,0,0,5,6,83.3,1,0,0,0,0,5,18,6,"Matches","https://fbref.com/en/comps/9/2023-2024/defense/2023-2024-Premier-League-Stats"
189,"Pablo Fornals","/en/players/82927de4/Pablo-Fornals","es ESP","MF,FW","West Ham",27,1996,4.7,10,6,4,3,3,5,16,31.3,11,8,1,7,6,16,7,0,"Matches","https://fbref.com/en/comps/9/2023-2024/defense/2023-2024-Premier-League-Stats"
190,"Omari Forson","/en/players/1b9728b0/Omari-Forson","eng ENG","FW","Manchester Utd",19,2004,0.8,2,0,0,2,0,1,1,100,0,0,0,0,0,2,0,0,"Matches","https://fbref.com/en/comps/9/2023-2024/defense/2023-2024-Premier-League-Stats"
191,"Lyle Foster","/en/players/f84a807c/Lyle-Foster","za RSA","FW,MF","Burnley",22,2000,21.1,19,10,5,6,8,6,17,35.3,11,13,3,10,3,22,34,0,"Matches","https://fbref.com/en/comps/9/2023-2024/defense/2023-2024-Premier-League-Stats"
192,"Matheus França","/en/players/077faf72/Matheus-Franca","br BRA","MF,FW","Crystal Palace",19,2004,2.6,3,3,2,1,0,1,7,14.3,6,4,0,4,1,4,1,0,"Matches","https://fbref.com/en/comps/9/2023-2024/defense/2023-2024-Premier-League-Stats"
193,"Nathan Fraser","/en/players/00b77ecf/Nathan-Fraser","ie IRL","FW","Wolves",18,2005,2.1,5,2,2,1,2,1,3,33.3,2,2,1,1,1,6,2,0,"Matches","https://fbref.com/en/comps/9/2023-2024/defense/2023-2024-Premier-League-Stats"
194,"Cody Gakpo","/en/players/1971591f/Cody-Gakpo","nl NED","FW,MF","Liverpool",24,1999,18.3,27,17,8,14,5,8,25,32,17,21,4,17,14,41,7,0,"Matches","https://fbref.com/en/comps/9/2023-2024/defense/2023-2024-Premier-League-Stats"
195,"Conor Gallagher","/en/players/c2731c10/Conor-Gallagher","eng ENG","MF","Chelsea",23,2000,34.8,85,52,37,31,17,33,77,42.9,44,50,11,39,43,128,34,0,"Matches","https://fbref.com/en/comps/9/2023-2024/defense/2023-2024-Premier-League-Stats"
196,"Idrissa Gana Gueye","/en/players/72c812f3/Idrissa-Gana-Gueye","sn SEN","MF","Everton",33,1989,20.9,73,44,32,27,14,29,46,63,17,24,7,17,28,101,16,0,"Matches","https://fbref.com/en/comps/9/2023-2024/defense/2023-2024-Premier-League-Stats"
197,"Alejandro Garnacho","/en/players/7aa8adfe/Alejandro-Garnacho","ar ARG","FW","Manchester Utd",19,2004,28.5,22,15,7,6,9,12,45,26.7,33,26,2,24,18,40,18,0,"Matches","https://fbref.com/en/comps/9/2023-2024/defense/2023-2024-Premier-League-Stats"
198,"James Garner","/en/players/4e015693/James-Garner","eng ENG","MF","Everton",22,2001,33.4,83,44,32,38,13,35,82,42.7,47,45,14,31,45,128,47,1,"Matches","https://fbref.com/en/comps/9/2023-2024/defense/2023-2024-Premier-League-Stats"
199,"Saman Ghoddos","/en/players/f7b1d4e0/Saman-Ghoddos","ir IRN","DF","Brentford",29,1993,8.2,28,19,19,7,2,17,31,54.8,14,9,2,7,5,33,12,0,"Matches","https://fbref.com/en/comps/9/2023-2024/defense/2023-2024-Premier-League-Stats"
200,"Morgan Gibbs-White","/en/players/32f60ed8/Morgan-Gibbs-White","eng ENG","MF,FW","Nott'ham Forest",23,2000,35.1,36,24,6,20,10,14,33,42.4,19,31,8,23,17,53,21,0,"Matches","https://fbref.com/en/comps/9/2023-2024/defense/2023-2024-Premier-League-Stats"
201,"Bryan Gil","/en/players/7b5ab7f2/Bryan-Gil","es ESP","FW,MF","Tottenham",22,2001,2.3,1,0,0,0,1,1,4,25,3,3,0,3,3,4,4,0,"Matches","https://fbref.com/en/comps/9/2023-2024/defense/2023-2024-Premier-League-Stats"
202,"Alfie Gilchrist","/en/players/d91f104d/Alfie-Gilchrist","eng ENG","DF","Chelsea",19,2003,2.3,4,0,4,0,0,2,5,40,3,6,3,3,3,7,11,0,"Matches","https://fbref.com/en/comps/9/2023-2024/defense/2023-2024-Premier-League-Stats"
203,"Ryan Giles","/en/players/73b1d65b/Ryan-Giles","eng ENG","DF,MF","Luton Town",23,2000,5.6,8,6,4,3,1,2,7,28.6,5,2,0,2,4,12,22,0,"Matches","https://fbref.com/en/comps/9/2023-2024/defense/2023-2024-Premier-League-Stats"
204,"Billy Gilmour","/en/players/df10e27c/Billy-Gilmour","sct SCO","MF","Brighton",22,2001,23.6,26,16,14,10,2,11,35,31.4,24,23,9,14,11,37,14,1,"Matches","https://fbref.com/en/comps/9/2023-2024/defense/2023-2024-Premier-League-Stats"
205,"Ben Godfrey","/en/players/9f7c837d/Ben-Godfrey","eng ENG","DF","Everton",25,1998,12.4,30,20,17,8,5,15,28,53.6,13,14,8,6,16,46,57,0,"Matches","https://fbref.com/en/comps/9/2023-2024/defense/2023-2024-Premier-League-Stats"
206,"André Gomes","/en/players/1961b2aa/Andre-Gomes","pt POR","MF,FW","Everton",30,1993,5.6,7,4,2,3,2,3,13,23.1,10,10,1,9,3,10,4,1,"Matches","https://fbref.com/en/comps/9/2023-2024/defense/2023-2024-Premier-League-Stats"
207,"João Gomes","/en/players/8b57ad2c/Joao-Gomes","br BRA","MF","Wolves",22,2001,29.4,128,74,67,49,12,44,99,44.4,55,51,8,43,18,146,29,2,"Matches","https://fbref.com/en/comps/9/2023-2024/defense/2023-2024-Premier-League-Stats"
208,"Toti Gomes","/en/players/f0caab96/Toti-Gomes","pt POR","DF","Wolves",24,1999,30.8,44,25,32,8,4,24,37,64.9,13,40,19,21,26,70,93,2,"Matches","https://fbref.com/en/comps/9/2023-2024/defense/2023-2024-Premier-League-Stats"
209,"Joe Gomez","/en/players/7a11550b/Joe-Gomez","eng ENG","DF","Liverpool",26,1997,19.8,47,31,24,16,7,30,63,47.6,33,26,4,22,19,66,50,2,"Matches","https://fbref.com/en/comps/9/2023-2024/defense/2023-2024-Premier-League-Stats"
210,"Sergio Gómez","/en/players/01e5f06e/Sergio-Gomez","es ESP","FW,MF","Manchester City",22,2000,0.6,1,0,0,1,0,1,2,50,1,0,0,0,1,2,0,0,"Matches","https://fbref.com/en/comps/9/2023-2024/defense/2023-2024-Premier-League-Stats"
211,"Enso Gonzalez","/en/players/7e5bebeb/Enso-Gonzalez","py PAR","MF,DF","Wolves",18,2005,0,0,0,0,0,0,0,1,0,1,0,0,0,0,0,0,0,"Matches","https://fbref.com/en/comps/9/2023-2024/defense/2023-2024-Premier-League-Stats"
212,"Anthony Gordon","/en/players/2bd83368/Anthony-Gordon","eng ENG","FW","Newcastle Utd",22,2001,32.1,55,34,16,28,11,22,64,34.4,42,27,0,27,7,62,7,0,"Matches","https://fbref.com/en/comps/9/2023-2024/defense/2023-2024-Premier-League-Stats"
213,"Kaide Gordon","/en/players/19a9cb70/Kaide-Gordon","eng ENG","FW","Liverpool",18,2004,0,0,0,0,0,0,0,0,NA,0,0,0,0,0,0,0,0,"Matches","https://fbref.com/en/comps/9/2023-2024/defense/2023-2024-Premier-League-Stats"
214,"Daniel Gore","/en/players/861e9b3b/Daniel-Gore","eng ENG","MF","Manchester Utd",18,2004,0,1,1,0,1,0,1,1,100,0,0,0,0,1,2,0,0,"Matches","https://fbref.com/en/comps/9/2023-2024/defense/2023-2024-Premier-League-Stats"
215,"Ryan Gravenberch","/en/players/b8e740fb/Ryan-Gravenberch","nl NED","MF","Liverpool",21,2002,12.5,26,12,5,13,8,12,29,41.4,17,20,2,18,14,40,11,0,"Matches","https://fbref.com/en/comps/9/2023-2024/defense/2023-2024-Premier-League-Stats"
216,"Ivo Grbić","/en/players/3f034750/Ivo-Grbic","hr CRO","GK","Sheffield Utd",27,1996,8.6,0,0,0,0,0,0,1,0,1,1,0,1,0,0,9,1,"Matches","https://fbref.com/en/comps/9/2023-2024/defense/2023-2024-Premier-League-Stats"
217,"Jack Grealish","/en/players/b0b4fd3e/Jack-Grealish","eng ENG","FW,MF","Manchester City",27,1995,11.2,13,8,6,7,0,6,12,50,6,13,2,11,6,19,5,0,"Matches","https://fbref.com/en/comps/9/2023-2024/defense/2023-2024-Premier-League-Stats"
218,"Pascal Groß","/en/players/8aec0537/Pascal-Gross","de GER","MF,DF","Brighton",32,1991,34.6,70,46,33,21,16,31,72,43.1,41,41,8,33,22,92,32,3,"Matches","https://fbref.com/en/comps/9/2023-2024/defense/2023-2024-Premier-League-Stats"
219,"Marc Guéhi","/en/players/d0706b27/Marc-Guehi","eng ENG","DF","Crystal Palace",23,2000,22.5,28,19,21,7,0,14,24,58.3,10,22,17,5,18,46,89,1,"Matches","https://fbref.com/en/comps/9/2023-2024/defense/2023-2024-Premier-League-Stats"
220,"Bruno Guimarães","/en/players/82518f62/Bruno-Guimaraes","br BRA","MF","Newcastle Utd",25,1997,36.3,88,53,45,32,11,40,77,51.9,37,52,14,38,35,123,20,0,"Matches","https://fbref.com/en/comps/9/2023-2024/defense/2023-2024-Premier-League-Stats"
221,"Malo Gusto","/en/players/d56b9520/Malo-Gusto","fr FRA","DF","Chelsea",20,2003,19.5,55,27,34,15,6,35,52,67.3,17,28,4,24,17,72,43,1,"Matches","https://fbref.com/en/comps/9/2023-2024/defense/2023-2024-Premier-League-Stats"
222,"Joško Gvardiol","/en/players/5ad50391/Josko-Gvardiol","hr CRO","DF","Manchester City",21,2002,25.9,55,33,21,24,10,21,38,55.3,17,36,12,24,27,82,37,3,"Matches","https://fbref.com/en/comps/9/2023-2024/defense/2023-2024-Premier-League-Stats"
223,"Erling Haaland","/en/players/1f44ac21/Erling-Haaland","no NOR","FW","Manchester City",23,2000,28.4,6,3,0,3,3,2,3,66.7,1,11,1,10,2,8,16,0,"Matches","https://fbref.com/en/comps/9/2023-2024/defense/2023-2024-Premier-League-Stats"
224,"Antwoine Hackford","/en/players/a7588cdc/Antwoine-Hackford","eng ENG","FW","Sheffield Utd",19,2004,0.1,0,0,0,0,0,0,0,NA,0,0,0,0,0,0,0,0,"Matches","https://fbref.com/en/comps/9/2023-2024/defense/2023-2024-Premier-League-Stats"
225,"Lewis Hall","/en/players/da011f18/Lewis-Hall","eng ENG","DF","Newcastle Utd",18,2004,8.7,28,18,17,10,1,17,28,60.7,11,17,2,15,12,40,22,1,"Matches","https://fbref.com/en/comps/9/2023-2024/defense/2023-2024-Premier-League-Stats"
226,"Gustavo Hamer","/en/players/eebacc07/Gustavo-Hamer","nl NED","MF","Sheffield Utd",26,1997,32.3,39,21,17,15,7,16,59,27.1,43,33,9,24,29,68,35,0,"Matches","https://fbref.com/en/comps/9/2023-2024/defense/2023-2024-Premier-League-Stats"
227,"Luke Harris","/en/players/8c3078cd/Luke-Harris","wls WAL","MF","Fulham",18,2005,0.8,1,1,1,0,0,0,1,0,1,0,0,0,0,1,0,0,"Matches","https://fbref.com/en/comps/9/2023-2024/defense/2023-2024-Premier-League-Stats"
228,"Jack Harrison","/en/players/aa849a12/Jack-Harrison","eng ENG","MF,FW","Everton",26,1996,24.6,37,22,12,12,13,17,49,34.7,32,25,5,20,12,49,24,0,"Matches","https://fbref.com/en/comps/9/2023-2024/defense/2023-2024-Premier-League-Stats"
229,"Daiki Hashioka","/en/players/10cb48b7/Daiki-Hashioka","jp JPN","DF","Luton Town",24,1999,6.6,11,5,6,4,1,5,11,45.5,6,12,7,5,8,19,20,0,"Matches","https://fbref.com/en/comps/9/2023-2024/defense/2023-2024-Premier-League-Stats"
230,"Kai Havertz","/en/players/fed7cb61/Kai-Havertz","de GER","MF,FW","Arsenal",24,1999,29.3,35,15,7,21,7,14,39,35.9,25,26,1,25,20,55,22,0,"Matches","https://fbref.com/en/comps/9/2023-2024/defense/2023-2024-Premier-League-Stats"
231,"Jan Paul van Hecke","/en/players/4fd08daa/Jan-Paul-van-Hecke","nl NED","DF","Brighton",23,2000,26.3,47,26,25,19,3,27,45,60,18,49,27,22,30,77,76,4,"Matches","https://fbref.com/en/comps/9/2023-2024/defense/2023-2024-Premier-League-Stats"
232,"Hwang Hee-chan","/en/players/169fd162/Hwang-Hee-chan","kr KOR","FW,MF","Wolves",27,1996,23.5,20,10,11,8,1,9,24,37.5,15,19,1,18,10,30,9,0,"Matches","https://fbref.com/en/comps/9/2023-2024/defense/2023-2024-Premier-League-Stats"
233,"Dean Henderson","/en/players/e5a76dfe/Dean-Henderson","eng ENG","GK","Crystal Palace",26,1997,18,1,1,1,0,0,1,2,50,1,0,0,0,0,1,8,2,"Matches","https://fbref.com/en/comps/9/2023-2024/defense/2023-2024-Premier-League-Stats"
234,"Rico Henry","/en/players/8a3c1dc7/Rico-Henry","eng ENG","DF","Brentford",26,1997,4.5,7,5,3,3,1,6,7,85.7,1,8,3,5,5,12,5,1,"Matches","https://fbref.com/en/comps/9/2023-2024/defense/2023-2024-Premier-League-Stats"
235,"Son Heung-min","/en/players/92e7e919/Son-Heung-min","kr KOR","FW","Tottenham",31,1992,32.6,21,13,6,7,8,10,21,47.6,11,4,1,3,8,29,4,0,"Matches","https://fbref.com/en/comps/9/2023-2024/defense/2023-2024-Premier-League-Stats"
236,"Aaron Hickey","/en/players/1780bb4a/Aaron-Hickey","sct SCO","DF","Brentford",21,2002,7.9,16,9,9,3,4,7,7,100,0,7,3,4,3,19,10,0,"Matches","https://fbref.com/en/comps/9/2023-2024/defense/2023-2024-Premier-League-Stats"
237,"James Hill","/en/players/69942fb3/James-Hill","eng ENG","DF","Bournemouth",21,2002,0.8,3,2,1,2,0,1,1,100,0,3,2,1,3,6,8,0,"Matches","https://fbref.com/en/comps/9/2023-2024/defense/2023-2024-Premier-League-Stats"
238,"Jack Hinshelwood","/en/players/e98211e7/Jack-Hinshelwood","eng ENG","DF","Brighton",18,2005,9.7,14,5,7,4,3,5,13,38.5,8,6,2,4,14,28,18,0,"Matches","https://fbref.com/en/comps/9/2023-2024/defense/2023-2024-Premier-League-Stats"
239,"Mason Holgate","/en/players/d0042ab9/Mason-Holgate","eng ENG","DF","Sheffield Utd",26,1996,7.9,12,7,5,6,1,5,12,41.7,7,12,5,7,11,23,40,0,"Matches","https://fbref.com/en/comps/9/2023-2024/defense/2023-2024-Premier-League-Stats"
240,"Callum Hudson-Odoi","/en/players/15f3ec41/Callum-Hudson-Odoi","eng ENG","FW,MF","Nott'ham Forest",22,2000,20.6,18,8,4,5,9,7,28,25,21,16,1,15,7,25,12,1,"Matches","https://fbref.com/en/comps/9/2023-2024/defense/2023-2024-Premier-League-Stats"
241,"Will Hughes","/en/players/a0666d3e/Will-Hughes","eng ENG","MF","Crystal Palace",28,1995,21,61,33,30,20,11,24,48,50,24,36,14,22,21,82,25,0,"Matches","https://fbref.com/en/comps/9/2023-2024/defense/2023-2024-Premier-League-Stats"
242,"Pierre Højbjerg","/en/players/8b04d6c1/Pierre-Hojbjerg","dk DEN","MF","Tottenham",27,1995,14.6,32,18,13,17,2,13,34,38.2,21,21,7,14,19,51,30,3,"Matches","https://fbref.com/en/comps/9/2023-2024/defense/2023-2024-Premier-League-Stats"
243,"Rasmus Højlund","/en/players/491a433d/Rasmus-Hojlund","dk DEN","FW","Manchester Utd",20,2003,24,11,7,2,3,6,5,13,38.5,8,9,1,8,1,12,19,0,"Matches","https://fbref.com/en/comps/9/2023-2024/defense/2023-2024-Premier-League-Stats"
244,"Igor","/en/players/a4e85758/Igor","br BRA","DF","Brighton",25,1998,18.2,25,18,7,16,2,17,29,58.6,12,22,9,13,14,39,52,1,"Matches","https://fbref.com/en/comps/9/2023-2024/defense/2023-2024-Premier-League-Stats"
245,"Danny Ings","/en/players/07802f7f/Danny-Ings","eng ENG","FW","West Ham",31,1992,4.5,6,2,0,6,0,4,13,30.8,9,4,1,3,3,9,7,0,"Matches","https://fbref.com/en/comps/9/2023-2024/defense/2023-2024-Premier-League-Stats"
246,"Tim Iroegbunam","/en/players/84c5ceea/Tim-Iroegbunam","eng ENG","MF","Aston Villa",20,2003,1.8,7,5,4,2,1,4,9,44.4,5,3,0,3,2,9,3,0,"Matches","https://fbref.com/en/comps/9/2023-2024/defense/2023-2024-Premier-League-Stats"
247,"Alexander Isak","/en/players/8e92be30/Alexander-Isak","se SWE","FW","Newcastle Utd",23,1999,25.1,5,0,2,1,2,2,8,25,6,16,1,15,6,11,13,0,"Matches","https://fbref.com/en/comps/9/2023-2024/defense/2023-2024-Premier-League-Stats"
248,"Alex Iwobi","/en/players/6ca5ec4b/Alex-Iwobi","ng NGA","MF","Everton",27,1996,1.6,2,0,1,0,1,2,3,66.7,1,2,0,2,1,3,0,0,"Matches","https://fbref.com/en/comps/9/2023-2024/defense/2023-2024-Premier-League-Stats"
249,"Alex Iwobi","/en/players/6ca5ec4b/Alex-Iwobi","ng NGA","FW,MF","Fulham",27,1996,24.4,29,18,12,15,2,12,25,48,13,16,0,16,14,43,9,0,"Matches","https://fbref.com/en/comps/9/2023-2024/defense/2023-2024-Premier-League-Stats"
250,"Nicolas Jackson","/en/players/9c36ed83/Nicolas-Jackson","sn SEN","FW","Chelsea",22,2001,31.1,21,13,5,8,8,5,24,20.8,19,20,5,15,4,25,17,0,"Matches","https://fbref.com/en/comps/9/2023-2024/defense/2023-2024-Premier-League-Stats"
251,"Reece James","/en/players/1265a93a/Reece-James","eng ENG","DF","Chelsea",23,1999,4.7,14,9,10,3,1,8,10,80,2,4,4,0,3,17,7,1,"Matches","https://fbref.com/en/comps/9/2023-2024/defense/2023-2024-Premier-League-Stats"
252,"Vitaly Janelt","/en/players/8449d35e/Vitaly-Janelt","de GER","MF,DF","Brentford",25,1998,33.9,63,38,29,25,9,32,64,50,32,35,9,26,36,99,64,3,"Matches","https://fbref.com/en/comps/9/2023-2024/defense/2023-2024-Premier-League-Stats"
253,"Daniel Jebbison","/en/players/03edb878/Daniel-Jebbison","eng ENG","FW","Sheffield Utd",19,2003,0.2,0,0,0,0,0,0,0,NA,0,1,0,1,0,0,0,0,"Matches","https://fbref.com/en/comps/9/2023-2024/defense/2023-2024-Premier-League-Stats"
254,"Mathias Jensen","/en/players/0f134faf/Mathias-Jensen","dk DEN","MF","Brentford",27,1996,24.5,54,32,25,22,7,26,95,27.4,69,41,6,35,23,77,25,1,"Matches","https://fbref.com/en/comps/9/2023-2024/defense/2023-2024-Premier-League-Stats"
255,"Gabriel Jesus","/en/players/b66315ae/Gabriel-Jesus","br BRA","FW","Arsenal",26,1997,16.4,24,17,11,5,8,5,18,27.8,13,23,1,22,13,37,12,0,"Matches","https://fbref.com/en/comps/9/2023-2024/defense/2023-2024-Premier-League-Stats"
256,"Raúl Jiménez","/en/players/b561db50/Raul-Jimenez","mx MEX","FW","Fulham",32,1991,15.5,18,12,4,8,6,7,20,35,13,11,3,8,4,22,13,0,"Matches","https://fbref.com/en/comps/9/2023-2024/defense/2023-2024-Premier-League-Stats"
257,"João Pedro","/en/players/e8832875/Joao-Pedro","br BRA","FW,MF","Brighton",21,2001,22.7,31,14,10,13,8,14,24,58.3,10,15,2,13,11,42,28,0,"Matches","https://fbref.com/en/comps/9/2023-2024/defense/2023-2024-Premier-League-Stats"
258,"Joelinton","/en/players/c17bfb65/Joelinton","br BRA","MF,FW","Newcastle Utd",26,1996,14.2,39,27,21,15,3,14,38,36.8,24,23,7,16,19,58,11,1,"Matches","https://fbref.com/en/comps/9/2023-2024/defense/2023-2024-Premier-League-Stats"
259,"Ben Johnson","/en/players/9319781b/Ben-Johnson","eng ENG","DF,FW","West Ham",23,2000,6,11,7,7,3,1,9,14,64.3,5,2,1,1,5,16,14,0,"Matches","https://fbref.com/en/comps/9/2023-2024/defense/2023-2024-Premier-League-Stats"
260,"Brennan Johnson","/en/players/0cd31129/Brennan-Johnson","wls WAL","FW","Tottenham",22,2001,23.2,26,15,14,5,7,12,31,38.7,19,37,1,36,10,36,12,1,"Matches","https://fbref.com/en/comps/9/2023-2024/defense/2023-2024-Premier-League-Stats"
261,"Brennan Johnson","/en/players/0cd31129/Brennan-Johnson","wls WAL","FW,MF","Nott'ham Forest",22,2001,2.6,4,1,1,1,2,2,4,50,2,4,1,3,0,4,0,0,"Matches","https://fbref.com/en/comps/9/2023-2024/defense/2023-2024-Premier-League-Stats"
262,"Joseph Johnson","/en/players/d9e7c4da/Joseph-Johnson","eng ENG","DF","Luton Town",17,2006,0.9,0,0,0,0,0,0,1,0,1,0,0,0,0,0,0,0,"Matches","https://fbref.com/en/comps/9/2023-2024/defense/2023-2024-Premier-League-Stats"
263,"Sam Johnstone","/en/players/9e5708be/Sam-Johnstone","eng ENG","GK","Crystal Palace",30,1993,20,1,0,1,0,0,1,1,100,0,0,0,0,1,2,5,0,"Matches","https://fbref.com/en/comps/9/2023-2024/defense/2023-2024-Premier-League-Stats"
264,"Curtis Jones","/en/players/4fb9c88f/Curtis-Jones","eng ENG","MF","Liverpool",22,2001,13,27,14,12,12,3,10,23,43.5,13,22,0,22,7,34,8,0,"Matches","https://fbref.com/en/comps/9/2023-2024/defense/2023-2024-Premier-League-Stats"
265,"Jorginho","/en/players/45db685d/Jorginho","it ITA","MF","Arsenal",31,1991,10.2,24,10,6,10,8,11,23,47.8,12,17,1,16,12,36,7,1,"Matches","https://fbref.com/en/comps/9/2023-2024/defense/2023-2024-Premier-League-Stats"
266,"Diogo Jota","/en/players/178ae8f8/Diogo-Jota","pt POR","FW","Liverpool",26,1996,12.7,23,13,6,13,4,10,23,43.5,13,9,1,8,7,30,4,0,"Matches","https://fbref.com/en/comps/9/2023-2024/defense/2023-2024-Premier-League-Stats"
267,"Mads Juel Andersen","/en/players/f098c03e/Mads-Juel-Andersen","dk DEN","DF","Luton Town",25,1997,4.4,6,5,4,2,0,4,4,100,0,9,6,3,8,14,29,0,"Matches","https://fbref.com/en/comps/9/2023-2024/defense/2023-2024-Premier-League-Stats"
268,"Hamed Junior Traorè","/en/players/570bb4b9/Hamed-Junior-Traore","ci CIV","MF","Bournemouth",23,2000,0.5,1,0,1,0,0,1,3,33.3,2,3,0,3,0,1,0,0,"Matches","https://fbref.com/en/comps/9/2023-2024/defense/2023-2024-Premier-League-Stats"
269,"Mathias Jørgensen","/en/players/0db5d2c8/Mathias-Jorgensen","dk DEN","DF","Brentford",33,1990,12.1,17,12,15,1,1,11,19,57.9,8,9,5,4,12,29,40,0,"Matches","https://fbref.com/en/comps/9/2023-2024/defense/2023-2024-Premier-League-Stats"
270,"Issa Kaboré","/en/players/c066d1a5/Issa-Kabore","bf BFA","DF","Luton Town",22,2001,19.2,52,28,23,21,8,24,45,53.3,21,22,11,11,16,68,56,2,"Matches","https://fbref.com/en/comps/9/2023-2024/defense/2023-2024-Premier-League-Stats"
271,"Sasa Kalajdzic","/en/players/15f24fe7/Sasa-Kalajdzic","at AUT","FW","Wolves",26,1997,1.8,6,2,3,2,1,1,2,50,1,3,0,3,1,7,6,0,"Matches","https://fbref.com/en/comps/9/2023-2024/defense/2023-2024-Premier-League-Stats"
272,"Boubacar Kamara","/en/players/cc77354e/Boubacar-Kamara","fr FRA","MF","Aston Villa",23,1999,18.4,43,29,16,21,6,24,47,51.1,23,21,7,14,21,64,16,0,"Matches","https://fbref.com/en/comps/9/2023-2024/defense/2023-2024-Premier-League-Stats"
273,"Willy Kambwala","/en/players/6a7353d7/Willy-Kambwala","fr FRA","DF","Manchester Utd",18,2004,3.7,3,1,1,2,0,1,3,33.3,2,6,3,3,4,7,14,1,"Matches","https://fbref.com/en/comps/9/2023-2024/defense/2023-2024-Premier-League-Stats"
274,"Thomas Kaminski","/en/players/1caa93a5/Thomas-Kaminski","be BEL","GK","Luton Town",30,1992,37.8,2,1,2,0,0,2,6,33.3,4,1,0,1,0,2,14,2,"Matches","https://fbref.com/en/comps/9/2023-2024/defense/2023-2024-Premier-League-Stats"
275,"Loris Karius","/en/players/32e7ce92/Loris-Karius","de GER","GK","Newcastle Utd",30,1993,1,0,0,0,0,0,0,0,NA,0,0,0,0,0,0,1,0,"Matches","https://fbref.com/en/comps/9/2023-2024/defense/2023-2024-Premier-League-Stats"
276,"Michael Keane","/en/players/c5b7c315/Michael-Keane","eng ENG","DF","Everton",30,1993,4.9,7,3,3,3,1,1,7,14.3,6,5,4,1,5,12,18,1,"Matches","https://fbref.com/en/comps/9/2023-2024/defense/2023-2024-Premier-League-Stats"
277,"Thilo Kehrer","/en/players/51dbeea9/Thilo-Kehrer","de GER","DF,MF","West Ham",26,1996,0.2,1,1,0,1,0,0,0,NA,0,2,2,0,0,1,0,0,"Matches","https://fbref.com/en/comps/9/2023-2024/defense/2023-2024-Premier-League-Stats"
278,"Caoimhín Kelleher","/en/players/62d7ef38/Caoimhin-Kelleher","ie IRL","GK","Liverpool",24,1998,10,0,0,0,0,0,0,0,NA,0,0,0,0,0,0,4,1,"Matches","https://fbref.com/en/comps/9/2023-2024/defense/2023-2024-Premier-League-Stats"
279,"Lloyd Kelly","/en/players/f31def1e/Lloyd-Kelly","eng ENG","DF","Bournemouth",24,1998,17.3,24,19,10,9,5,14,25,56,11,22,12,10,13,37,67,0,"Matches","https://fbref.com/en/comps/9/2023-2024/defense/2023-2024-Premier-League-Stats"
280,"Omari Kellyman","/en/players/aa888da7/Omari-Kellyman","eng ENG","FW","Aston Villa",17,2005,0.4,1,0,0,1,0,1,2,50,1,0,0,0,0,1,0,0,"Matches","https://fbref.com/en/comps/9/2023-2024/defense/2023-2024-Premier-League-Stats"
281,"Milos Kerkez","/en/players/0ad53bdc/Milos-Kerkez","hu HUN","DF","Bournemouth",19,2003,21.9,47,26,31,13,3,30,42,71.4,12,31,11,20,20,67,60,2,"Matches","https://fbref.com/en/comps/9/2023-2024/defense/2023-2024-Premier-League-Stats"
282,"Kaine Kesler-Hayden","/en/players/9b066938/Kaine-Kesler-Hayden","eng ENG","MF,DF","Aston Villa",20,2002,0.1,0,0,0,0,0,0,0,NA,0,0,0,0,0,0,0,0,"Matches","https://fbref.com/en/comps/9/2023-2024/defense/2023-2024-Premier-League-Stats"
283,"Max Kilman","/en/players/d0f72bf1/Max-Kilman","eng ENG","DF","Wolves",26,1997,38,47,21,40,6,1,24,32,75,8,64,37,27,39,86,182,4,"Matches","https://fbref.com/en/comps/9/2023-2024/defense/2023-2024-Premier-League-Stats"
284,"Jakub Kiwior","/en/players/dc3e663e/Jakub-Kiwior","pl POL","DF","Arsenal",23,2000,10.5,20,12,11,8,1,14,19,73.7,5,11,3,8,8,28,28,1,"Matches","https://fbref.com/en/comps/9/2023-2024/defense/2023-2024-Premier-League-Stats"
285,"Justin Kluivert","/en/players/4c3a6744/Justin-Kluivert","nl NED","MF,FW","Bournemouth",24,1999,21.3,28,14,5,12,11,8,30,26.7,22,16,1,15,8,36,11,0,"Matches","https://fbref.com/en/comps/9/2023-2024/defense/2023-2024-Premier-League-Stats"
286,"Luca Koleosho","/en/players/fc076f78/Luca-Koleosho","it ITA","MF,FW","Burnley",18,2004,10.8,7,4,2,5,0,2,10,20,8,13,0,13,2,9,0,0,"Matches","https://fbref.com/en/comps/9/2023-2024/defense/2023-2024-Premier-League-Stats"
287,"Ibrahima Konaté","/en/players/5ed9b537/Ibrahima-Konate","fr FRA","DF","Liverpool",24,1999,17.5,36,22,22,13,1,18,24,75,6,18,12,6,20,56,51,1,"Matches","https://fbref.com/en/comps/9/2023-2024/defense/2023-2024-Premier-League-Stats"
288,"Ezri Konsa","/en/players/0313a347/Ezri-Konsa","eng ENG","DF","Aston Villa",25,1997,34.1,54,32,28,23,3,23,27,85.2,4,36,20,16,28,82,73,3,"Matches","https://fbref.com/en/comps/9/2023-2024/defense/2023-2024-Premier-League-Stats"
289,"Cheikhou Kouyaté","/en/players/8d3c902d/Cheikhou-Kouyate","sn SEN","MF","Nott'ham Forest",33,1989,2.4,8,5,3,3,2,1,4,25,3,4,1,3,2,10,10,0,"Matches","https://fbref.com/en/comps/9/2023-2024/defense/2023-2024-Premier-League-Stats"
290,"Mateo Kovačić","/en/players/79c0821a/Mateo-Kovacic","hr CRO","MF","Manchester City",29,1994,17.2,36,25,16,15,5,18,28,64.3,10,23,1,22,10,46,10,0,"Matches","https://fbref.com/en/comps/9/2023-2024/defense/2023-2024-Premier-League-Stats"
291,"Emil Krafth","/en/players/77cf6852/Emil-Krafth","se SWE","DF","Newcastle Utd",28,1994,10.1,21,14,10,7,4,12,25,48,13,8,3,5,9,30,21,0,"Matches","https://fbref.com/en/comps/9/2023-2024/defense/2023-2024-Premier-League-Stats"
292,"Mohammed Kudus","/en/players/b62878a5/Mohammed-Kudus","gh GHA","FW,MF","West Ham",22,2000,27.6,65,47,27,27,11,20,40,50,20,25,0,25,11,76,9,1,"Matches","https://fbref.com/en/comps/9/2023-2024/defense/2023-2024-Premier-League-Stats"
293,"Dejan Kulusevski","/en/players/df3cda47/Dejan-Kulusevski","se SWE","FW,MF","Tottenham",23,2000,30.7,62,33,19,20,23,25,67,37.3,42,24,1,23,18,80,2,1,"Matches","https://fbref.com/en/comps/9/2023-2024/defense/2023-2024-Premier-League-Stats"
294,"Adam Lallana","/en/players/99813635/Adam-Lallana","eng ENG","MF,FW","Brighton",35,1988,9.4,8,3,4,4,0,0,4,0,4,2,1,1,3,11,1,0,"Matches","https://fbref.com/en/comps/9/2023-2024/defense/2023-2024-Premier-League-Stats"
295,"Tariq Lamptey","/en/players/f4e433d4/Tariq-Lamptey","gh GHA","DF,FW","Brighton",22,2000,10.2,21,14,14,5,2,13,22,59.1,9,7,3,4,6,27,6,0,"Matches","https://fbref.com/en/comps/9/2023-2024/defense/2023-2024-Premier-League-Stats"
296,"Aymeric Laporte","/en/players/119b9a8e/Aymeric-Laporte","es ESP","DF","Manchester City",29,1994,0.1,0,0,0,0,0,0,0,NA,0,1,1,0,0,0,1,0,"Matches","https://fbref.com/en/comps/9/2023-2024/defense/2023-2024-Premier-League-Stats"
297,"Yasser Larouci","/en/players/0ed063d6/Yasser-Larouci","dz ALG","DF","Sheffield Utd",22,2001,5.9,17,9,10,5,2,10,14,71.4,4,6,1,5,7,24,20,1,"Matches","https://fbref.com/en/comps/9/2023-2024/defense/2023-2024-Premier-League-Stats"
298,"Jamaal Lascelles","/en/players/450ab6fc/Jamaal-Lascelles","eng ENG","DF","Newcastle Utd",29,1993,12,14,9,7,7,0,6,11,54.5,5,17,12,5,5,19,42,0,"Matches","https://fbref.com/en/comps/9/2023-2024/defense/2023-2024-Premier-League-Stats"
299,"Roméo Lavia","/en/players/ecad9aa5/Romeo-Lavia","be BEL","MF","Chelsea",19,2004,0.4,1,0,0,1,0,0,0,NA,0,0,0,0,0,1,1,0,"Matches","https://fbref.com/en/comps/9/2023-2024/defense/2023-2024-Premier-League-Stats"
300,"Mario Lemina","/en/players/2b471f99/Mario-Lemina","ga GAB","MF","Wolves",29,1993,33,90,58,46,33,11,25,47,53.2,22,36,9,27,41,131,64,0,"Matches","https://fbref.com/en/comps/9/2023-2024/defense/2023-2024-Premier-League-Stats"
301,"Clément Lenglet","/en/players/4f28a6ff/Clement-Lenglet","fr FRA","DF","Aston Villa",28,1995,12.8,13,9,7,5,1,7,13,53.8,6,19,11,8,7,20,47,1,"Matches","https://fbref.com/en/comps/9/2023-2024/defense/2023-2024-Premier-League-Stats"
302,"Bernd Leno","/en/players/2628fd2b/Bernd-Leno","de GER","GK","Fulham",31,1992,38,0,0,0,0,0,0,0,NA,0,0,0,0,0,0,14,1,"Matches","https://fbref.com/en/comps/9/2023-2024/defense/2023-2024-Premier-League-Stats"
303,"Jefferson Lerma","/en/players/9b5ce51a/Jefferson-Lerma","co COL","MF,DF","Crystal Palace",28,1994,26.7,42,25,15,23,4,19,40,47.5,21,31,12,19,36,78,72,0,"Matches","https://fbref.com/en/comps/9/2023-2024/defense/2023-2024-Premier-League-Stats"
304,"Rico Lewis","/en/players/b57e066e/Rico-Lewis","eng ENG","DF,MF","Manchester City",18,2004,9,10,7,4,4,2,3,7,42.9,4,7,1,6,4,14,6,0,"Matches","https://fbref.com/en/comps/9/2023-2024/defense/2023-2024-Premier-League-Stats"
305,"Keane Lewis-Potter","/en/players/41f08ac8/Keane-Lewis-Potter","eng ENG","FW,DF","Brentford",22,2001,16,17,7,5,11,1,7,15,46.7,8,10,2,8,7,24,23,0,"Matches","https://fbref.com/en/comps/9/2023-2024/defense/2023-2024-Premier-League-Stats"
306,"Victor Lindelöf","/en/players/f5deef4c/Victor-Lindelof","se SWE","DF","Manchester Utd",29,1994,14.8,15,10,8,7,0,5,13,38.5,8,18,9,9,12,27,40,1,"Matches","https://fbref.com/en/comps/9/2023-2024/defense/2023-2024-Premier-League-Stats"
307,"Valentino Livramento","/en/players/afed6722/Valentino-Livramento","eng ENG","DF","Newcastle Utd",20,2002,14.6,23,13,15,6,2,10,21,47.6,11,16,7,9,25,48,41,1,"Matches","https://fbref.com/en/comps/9/2023-2024/defense/2023-2024-Premier-League-Stats"
308,"Giovani Lo Celso","/en/players/d7553721/Giovani-Lo-Celso","ar ARG","MF","Tottenham",27,1996,5.6,22,13,10,8,4,9,14,64.3,5,4,1,3,5,27,2,0,"Matches","https://fbref.com/en/comps/9/2023-2024/defense/2023-2024-Premier-League-Stats"
309,"Tom Lockyer","/en/players/37118440/Tom-Lockyer","wls WAL","DF","Luton Town",28,1994,13,25,16,17,6,2,15,22,68.2,7,23,13,10,23,48,68,0,"Matches","https://fbref.com/en/comps/9/2023-2024/defense/2023-2024-Premier-League-Stats"
310,"Sean Longstaff","/en/players/a2b105e0/Sean-Longstaff","eng ENG","MF","Newcastle Utd",25,1997,30.5,54,30,17,29,8,24,63,38.1,39,43,7,36,17,71,23,0,"Matches","https://fbref.com/en/comps/9/2023-2024/defense/2023-2024-Premier-League-Stats"
311,"Max Lowe","/en/players/7af88b33/Max-Lowe","eng ENG","DF,MF","Sheffield Utd",26,1997,5.6,21,10,13,5,3,8,15,53.3,7,10,4,6,5,26,15,0,"Matches","https://fbref.com/en/comps/9/2023-2024/defense/2023-2024-Premier-League-Stats"
312,"Douglas Luiz","/en/players/6f7d826d/Douglas-Luiz","br BRA","MF","Aston Villa",25,1998,33.3,58,38,21,27,10,25,53,47.2,28,32,8,24,23,81,18,2,"Matches","https://fbref.com/en/comps/9/2023-2024/defense/2023-2024-Premier-League-Stats"
313,"Saša Lukić","/en/players/c6e8cf1f/Sasa-Lukic","rs SRB","MF","Fulham",26,1996,12.5,33,19,9,17,7,18,39,46.2,21,18,5,13,16,49,19,1,"Matches","https://fbref.com/en/comps/9/2023-2024/defense/2023-2024-Premier-League-Stats"
314,"Ian Maatsen","/en/players/cab9634e/Ian-Maatsen","nl NED","FW,MF","Chelsea",21,2002,2.3,3,2,1,1,1,0,4,0,4,4,0,4,3,6,10,0,"Matches","https://fbref.com/en/comps/9/2023-2024/defense/2023-2024-Premier-League-Stats"
315,"Alexis Mac Allister","/en/players/83d074ff/Alexis-Mac-Allister","ar ARG","MF","Liverpool",24,1998,28.9,99,55,35,50,14,59,125,47.2,66,65,8,57,35,134,25,1,"Matches","https://fbref.com/en/comps/9/2023-2024/defense/2023-2024-Premier-League-Stats"
316,"James Maddison","/en/players/ee38d9c5/James-Maddison","eng ENG","MF","Tottenham",26,1996,23.7,33,19,5,18,10,15,29,51.7,14,15,3,12,13,46,10,1,"Matches","https://fbref.com/en/comps/9/2023-2024/defense/2023-2024-Premier-League-Stats"
317,"Noni Madueke","/en/players/bf34eebd/Noni-Madueke","eng ENG","FW","Chelsea",21,2002,11.7,16,10,8,4,4,11,34,32.4,23,11,0,11,4,20,14,0,"Matches","https://fbref.com/en/comps/9/2023-2024/defense/2023-2024-Premier-League-Stats"
318,"Gabriel Magalhães","/en/players/67ac5bb8/Gabriel-Magalhaes","br BRA","DF","Arsenal",25,1997,33.8,48,28,24,22,2,17,22,77.3,5,44,33,11,31,79,100,1,"Matches","https://fbref.com/en/comps/9/2023-2024/defense/2023-2024-Premier-League-Stats"
319,"Harry Maguire","/en/players/d8931174/Harry-Maguire","eng ENG","DF","Manchester Utd",30,1993,18.4,24,17,14,10,0,12,22,54.5,10,33,24,9,25,49,83,1,"Matches","https://fbref.com/en/comps/9/2023-2024/defense/2023-2024-Premier-League-Stats"
320,"Kobbie Mainoo","/en/players/c6220452/Kobbie-Mainoo","eng ENG","MF","Manchester Utd",18,2005,21.4,47,27,20,16,11,21,45,46.7,24,20,12,8,22,69,30,1,"Matches","https://fbref.com/en/comps/9/2023-2024/defense/2023-2024-Premier-League-Stats"
321,"Orel Mangala","/en/players/a572e291/Orel-Mangala","be BEL","MF","Nott'ham Forest",25,1998,17.4,27,13,16,10,1,14,29,48.3,15,12,6,6,26,53,32,0,"Matches","https://fbref.com/en/comps/9/2023-2024/defense/2023-2024-Premier-League-Stats"
322,"Benson Manuel","/en/players/d7f99582/Benson-Manuel","ao ANG","MF,FW","Burnley",26,1997,1.3,3,2,2,1,0,0,0,NA,0,1,0,1,0,3,0,0,"Matches","https://fbref.com/en/comps/9/2023-2024/defense/2023-2024-Premier-League-Stats"
323,"Solly March","/en/players/bb5fbd2b/Solly-March","eng ENG","FW,DF","Brighton",29,1994,6.2,19,14,9,7,3,8,14,57.1,6,5,0,5,11,30,8,0,"Matches","https://fbref.com/en/comps/9/2023-2024/defense/2023-2024-Premier-League-Stats"
324,"Anthony Martial","/en/players/8b788c01/Anthony-Martial","fr FRA","FW","Manchester Utd",27,1995,5,4,1,1,1,2,1,1,100,0,4,0,4,0,4,3,0,"Matches","https://fbref.com/en/comps/9/2023-2024/defense/2023-2024-Premier-League-Stats"
325,"Gabriel Martinelli","/en/players/48a5a5d6/Gabriel-Martinelli","br BRA","FW","Arsenal",22,2001,22.4,30,24,9,12,9,13,32,40.6,19,23,1,22,5,35,9,1,"Matches","https://fbref.com/en/comps/9/2023-2024/defense/2023-2024-Premier-League-Stats"
326,"Emiliano Martínez","/en/players/7956236f/Emiliano-Martinez","ar ARG","GK","Aston Villa",30,1992,33.5,0,0,0,0,0,0,0,NA,0,0,0,0,0,0,12,3,"Matches","https://fbref.com/en/comps/9/2023-2024/defense/2023-2024-Premier-League-Stats"
327,"Lisandro Martínez","/en/players/bac46a10/Lisandro-Martinez","ar ARG","DF","Manchester Utd",25,1998,7.2,12,8,8,4,0,5,12,41.7,7,10,8,2,5,17,26,0,"Matches","https://fbref.com/en/comps/9/2023-2024/defense/2023-2024-Premier-League-Stats"
328,"Han-Noah Massengo","/en/players/eba1e557/Han-Noah-Massengo","fr FRA","MF,DF","Burnley",22,2001,0.2,1,1,1,0,0,0,0,NA,0,1,0,1,0,1,0,0,"Matches","https://fbref.com/en/comps/9/2023-2024/defense/2023-2024-Premier-League-Stats"
329,"Pape Matar Sarr","/en/players/feb5d972/Pape-Matar-Sarr","sn SEN","MF","Tottenham",20,2002,23,34,24,11,17,6,15,36,41.7,21,21,5,16,31,65,28,1,"Matches","https://fbref.com/en/comps/9/2023-2024/defense/2023-2024-Premier-League-Stats"
330,"Jean-Philippe Mateta","/en/players/50e6dc35/Jean-Philippe-Mateta","fr FRA","FW","Crystal Palace",26,1997,25.4,22,15,4,11,7,6,10,60,4,13,4,9,4,26,14,0,"Matches","https://fbref.com/en/comps/9/2023-2024/defense/2023-2024-Premier-League-Stats"
331,"Joël Matip","/en/players/b217ef29/Joel-Matip","cm CMR","DF","Liverpool",31,1991,8.7,12,6,7,4,1,8,12,66.7,4,16,12,4,9,21,43,0,"Matches","https://fbref.com/en/comps/9/2023-2024/defense/2023-2024-Premier-League-Stats"
332,"Alex Matos","/en/players/ed383e43/Alex-Matos","eng ENG","MF","Chelsea",18,2004,0,0,0,0,0,0,0,0,NA,0,0,0,0,0,0,0,0,"Matches","https://fbref.com/en/comps/9/2023-2024/defense/2023-2024-Premier-League-Stats"
333,"Remi Matthews","/en/players/27f4f772/Remi-Matthews","eng ENG","GK","Crystal Palace",29,1994,0,0,0,0,0,0,0,0,NA,0,0,0,0,0,0,1,0,"Matches","https://fbref.com/en/comps/9/2023-2024/defense/2023-2024-Premier-League-Stats"
334,"Neal Maupay","/en/players/4bcf39f6/Neal-Maupay","fr FRA","FW","Brentford",26,1996,14.7,10,7,4,5,1,3,13,23.1,10,11,0,11,2,12,3,0,"Matches","https://fbref.com/en/comps/9/2023-2024/defense/2023-2024-Premier-League-Stats"
335,"Neal Maupay","/en/players/4bcf39f6/Neal-Maupay","fr FRA","FW","Everton",26,1996,1.2,0,0,0,0,0,0,1,0,1,2,0,2,0,0,1,0,"Matches","https://fbref.com/en/comps/9/2023-2024/defense/2023-2024-Premier-League-Stats"
336,"Konstantinos Mavropanos","/en/players/00963611/Konstantinos-Mavropanos","gr GRE","DF","West Ham",25,1997,16.7,28,16,17,9,2,17,21,81,4,21,13,8,23,51,79,3,"Matches","https://fbref.com/en/comps/9/2023-2024/defense/2023-2024-Premier-League-Stats"
337,"Bryan Mbeumo","/en/players/6afaebf2/Bryan-Mbeumo","cm CMR","FW","Brentford",23,1999,21.8,15,10,6,6,3,5,19,26.3,14,26,2,24,7,22,13,0,"Matches","https://fbref.com/en/comps/9/2023-2024/defense/2023-2024-Premier-League-Stats"
338,"James Mcatee","/en/players/96593e89/James-Mcatee","eng ENG","MF,FW","Sheffield Utd",20,2002,20.2,32,21,9,13,10,13,33,39.4,20,20,0,20,11,43,18,0,"Matches","https://fbref.com/en/comps/9/2023-2024/defense/2023-2024-Premier-League-Stats"
339,"James Mcatee","/en/players/96593e89/James-Mcatee","eng ENG","MF","Manchester City",20,2002,0,0,0,0,0,0,0,0,NA,0,1,0,1,0,0,0,0,"Matches","https://fbref.com/en/comps/9/2023-2024/defense/2023-2024-Premier-League-Stats"
340,"Oliver McBurnie","/en/players/78b8ac63/Oliver-McBurnie","sct SCO","FW","Sheffield Utd",27,1996,14.2,17,7,4,7,6,5,12,41.7,7,18,2,16,5,22,28,0,"Matches","https://fbref.com/en/comps/9/2023-2024/defense/2023-2024-Premier-League-Stats"
341,"James McConnell","/en/players/bf973eeb/James-McConnell","eng ENG","MF","Liverpool",18,2004,0,0,0,0,0,0,0,0,NA,0,1,0,1,1,1,0,0,"Matches","https://fbref.com/en/comps/9/2023-2024/defense/2023-2024-Premier-League-Stats"
342,"John McGinn","/en/players/90f91999/John-McGinn","sct SCO","MF,FW","Aston Villa",28,1994,33.3,59,35,18,34,7,32,77,41.6,45,33,4,29,21,80,21,0,"Matches","https://fbref.com/en/comps/9/2023-2024/defense/2023-2024-Premier-League-Stats"
343,"Scott McKenna","/en/players/4e5a4cbc/Scott-McKenna","sct SCO","DF","Nott'ham Forest",26,1996,4.6,4,0,3,1,0,2,3,66.7,1,6,4,2,5,9,27,0,"Matches","https://fbref.com/en/comps/9/2023-2024/defense/2023-2024-Premier-League-Stats"
344,"Dwight McNeil","/en/players/fc15fb84/Dwight-McNeil","eng ENG","MF,FW","Everton",23,1999,32.1,44,27,16,14,14,24,55,43.6,31,44,7,37,22,66,37,0,"Matches","https://fbref.com/en/comps/9/2023-2024/defense/2023-2024-Premier-League-Stats"
345,"Scott McTominay","/en/players/d93c2511/Scott-McTominay","sct SCO","MF,FW","Manchester Utd",26,1996,21.1,49,25,23,24,2,22,33,66.7,11,34,12,22,14,63,54,0,"Matches","https://fbref.com/en/comps/9/2023-2024/defense/2023-2024-Premier-League-Stats"
346,"Ben Mee","/en/players/8df7a2fb/Ben-Mee","eng ENG","DF","Brentford",33,1989,14.1,26,15,12,12,2,17,22,77.3,5,21,13,8,13,39,63,1,"Matches","https://fbref.com/en/comps/9/2023-2024/defense/2023-2024-Premier-League-Stats"
347,"Hannibal Mejbri","/en/players/ca22ccb0/Hannibal-Mejbri","tn TUN","MF,FW","Manchester Utd",20,2003,1.5,3,3,1,2,0,1,3,33.3,2,1,1,0,0,3,0,0,"Matches","https://fbref.com/en/comps/9/2023-2024/defense/2023-2024-Premier-League-Stats"
348,"Teden Mengi","/en/players/91748070/Teden-Mengi","eng ENG","DF","Luton Town",21,2002,27.4,54,22,33,20,1,19,30,63.3,11,39,27,12,57,111,140,1,"Matches","https://fbref.com/en/comps/9/2023-2024/defense/2023-2024-Premier-League-Stats"
349,"Chris Mepham","/en/players/fed96827/Chris-Mepham","wls WAL","DF","Bournemouth",25,1997,6.9,12,11,9,3,0,9,14,64.3,5,13,6,7,7,19,30,1,"Matches","https://fbref.com/en/comps/9/2023-2024/defense/2023-2024-Premier-League-Stats"
350,"Lewis Miley","/en/players/2c6835e5/Lewis-Miley","eng ENG","MF","Newcastle Utd",17,2006,13.4,33,21,6,20,7,15,32,46.9,17,20,3,17,8,41,18,2,"Matches","https://fbref.com/en/comps/9/2023-2024/defense/2023-2024-Premier-League-Stats"
351,"James Milner","/en/players/2f90f6b8/James-Milner","eng ENG","DF,MF","Brighton",37,1986,8.6,20,14,9,10,1,9,14,64.3,5,9,0,9,8,28,16,0,"Matches","https://fbref.com/en/comps/9/2023-2024/defense/2023-2024-Premier-League-Stats"
352,"Tyrone Mings","/en/players/8397a50c/Tyrone-Mings","eng ENG","DF","Aston Villa",30,1993,0.3,0,0,0,0,0,0,0,NA,0,0,0,0,1,1,1,0,"Matches","https://fbref.com/en/comps/9/2023-2024/defense/2023-2024-Premier-League-Stats"
353,"Tyrick Mitchell","/en/players/5cbd1eb0/Tyrick-Mitchell","eng ENG","DF,MF","Crystal Palace",23,1999,35.6,105,60,75,21,9,43,60,71.7,17,63,10,53,26,131,104,0,"Matches","https://fbref.com/en/comps/9/2023-2024/defense/2023-2024-Premier-League-Stats"
354,"Kaoru Mitoma","/en/players/74618572/Kaoru-Mitoma","jp JPN","FW","Brighton",26,1997,16.5,13,6,3,7,3,5,19,26.3,14,15,1,14,5,18,12,0,"Matches","https://fbref.com/en/comps/9/2023-2024/defense/2023-2024-Premier-League-Stats"
355,"Aleksandar Mitrović","/en/players/3925dbd6/Aleksandar-Mitrovic","rs SRB","FW","Fulham",28,1994,0.4,0,0,0,0,0,0,0,NA,0,0,0,0,0,0,0,0,"Matches","https://fbref.com/en/comps/9/2023-2024/defense/2023-2024-Premier-League-Stats"
356,"Jakub Moder","/en/players/f230bc30/Jakub-Moder","pl POL","MF,DF","Brighton",24,1999,6.9,19,10,9,5,5,9,18,50,9,8,2,6,2,21,12,0,"Matches","https://fbref.com/en/comps/9/2023-2024/defense/2023-2024-Premier-League-Stats"
357,"Gonzalo Montiel","/en/players/374d5158/Gonzalo-Montiel","ar ARG","DF","Nott'ham Forest",26,1997,8.9,22,19,12,8,2,16,29,55.2,13,8,3,5,9,31,31,1,"Matches","https://fbref.com/en/comps/9/2023-2024/defense/2023-2024-Premier-League-Stats"
358,"Kieffer Moore","/en/players/01ce9e70/Kieffer-Moore","wls WAL","FW,MF","Bournemouth",30,1992,1.2,0,0,0,0,0,0,0,NA,0,0,0,0,0,0,0,0,"Matches","https://fbref.com/en/comps/9/2023-2024/defense/2023-2024-Premier-League-Stats"
359,"Mikey Moore","/en/players/00953a9d/Mikey-Moore","eng ENG","MF","Tottenham",15,2007,0,0,0,0,0,0,0,0,NA,0,0,0,0,0,0,1,0,"Matches","https://fbref.com/en/comps/9/2023-2024/defense/2023-2024-Premier-League-Stats"
360,"Álex Moreno","/en/players/16e9d0ea/Alex-Moreno","es ESP","DF","Aston Villa",30,1993,11.5,18,12,18,0,0,12,19,63.2,7,11,2,9,13,31,37,0,"Matches","https://fbref.com/en/comps/9/2023-2024/defense/2023-2024-Premier-League-Stats"
361,"Carlton Morris","/en/players/2da834f1/Carlton-Morris","eng ENG","FW,MF","Luton Town",27,1995,31.8,15,8,4,6,5,9,15,60,6,24,5,19,1,16,53,0,"Matches","https://fbref.com/en/comps/9/2023-2024/defense/2023-2024-Premier-League-Stats"
362,"Mason Mount","/en/players/9674002f/Mason-Mount","eng ENG","MF,FW","Manchester Utd",24,1999,5.7,22,14,6,10,6,6,16,37.5,10,6,1,5,6,28,3,0,"Matches","https://fbref.com/en/comps/9/2023-2024/defense/2023-2024-Premier-League-Stats"
363,"Divin Mubama","/en/players/92868cb5/Divin-Mubama","eng ENG","FW","West Ham",18,2004,0.9,0,0,0,0,0,0,0,NA,0,0,0,0,0,0,0,0,"Matches","https://fbref.com/en/comps/9/2023-2024/defense/2023-2024-Premier-League-Stats"
364,"Mykhailo Mudryk","/en/players/049a888d/Mykhailo-Mudryk","ua UKR","FW","Chelsea",22,2001,17.5,21,12,9,7,5,10,32,31.3,22,14,1,13,9,30,9,0,"Matches","https://fbref.com/en/comps/9/2023-2024/defense/2023-2024-Premier-League-Stats"
365,"Rodrigo Muniz","/en/players/a755db8c/Rodrigo-Muniz","br BRA","FW","Fulham",22,2001,17.7,7,3,1,5,1,1,6,16.7,5,9,3,6,6,13,20,0,"Matches","https://fbref.com/en/comps/9/2023-2024/defense/2023-2024-Premier-League-Stats"
366,"Daniel Muñoz","/en/players/778ef829/Daniel-Munoz","co COL","DF,MF","Crystal Palace",27,1996,16,55,35,31,14,10,19,38,50,19,29,7,22,24,79,47,0,"Matches","https://fbref.com/en/comps/9/2023-2024/defense/2023-2024-Premier-League-Stats"
367,"Finley Munroe","/en/players/36625c27/Finley-Munroe","eng ENG","MF","Aston Villa",18,2005,0,0,0,0,0,0,0,0,NA,0,0,0,0,0,0,0,0,"Matches","https://fbref.com/en/comps/9/2023-2024/defense/2023-2024-Premier-League-Stats"
368,"Arijanet Muric","/en/players/99aa1a84/Arijanet-Muric","xk KVX","GK","Burnley",24,1998,10,1,1,1,0,0,1,1,100,0,0,0,0,0,1,10,4,"Matches","https://fbref.com/en/comps/9/2023-2024/defense/2023-2024-Premier-League-Stats"
369,"Murillo","/en/players/1704b0b8/Murillo","br BRA","DF","Nott'ham Forest",21,2002,31,50,31,36,13,1,19,33,57.6,14,41,24,17,37,87,188,0,"Matches","https://fbref.com/en/comps/9/2023-2024/defense/2023-2024-Premier-League-Stats"
370,"Alex Murphy","/en/players/f1c42eb3/Alex-Murphy","ie IRL","DF,FW","Newcastle Utd",19,2004,0.1,1,1,0,1,0,1,2,50,1,1,0,1,1,2,0,0,"Matches","https://fbref.com/en/comps/9/2023-2024/defense/2023-2024-Premier-League-Stats"
371,"Jacob Murphy","/en/players/de112b84/Jacob-Murphy","eng ENG","FW,DF","Newcastle Utd",28,1995,13.2,20,10,8,4,8,12,26,46.2,14,17,0,17,6,26,16,0,"Matches","https://fbref.com/en/comps/9/2023-2024/defense/2023-2024-Premier-League-Stats"
372,"Vitaliy Mykolenko","/en/players/30d4a2e5/Vitaliy-Mykolenko","ua UKR","DF","Everton",24,1999,27.4,69,38,46,21,2,41,66,62.1,25,36,11,25,36,105,92,0,"Matches","https://fbref.com/en/comps/9/2023-2024/defense/2023-2024-Premier-League-Stats"
373,"Marvelous Nakamba","/en/players/de5b5570/Marvelous-Nakamba","zw ZIM","MF","Luton Town",29,1994,12.6,40,24,24,14,2,24,42,57.1,18,23,6,17,11,51,11,1,"Matches","https://fbref.com/en/comps/9/2023-2024/defense/2023-2024-Premier-League-Stats"
374,"Michael Ndiweni","/en/players/8aff2b51/Michael-Ndiweni","eng ENG","FW","Newcastle Utd",19,2003,0,0,0,0,0,0,0,0,NA,0,0,0,0,0,0,0,0,"Matches","https://fbref.com/en/comps/9/2023-2024/defense/2023-2024-Premier-League-Stats"
375,"Reiss Nelson","/en/players/c5bdb6e3/Reiss-Nelson","eng ENG","FW","Arsenal",23,1999,3,9,6,5,1,3,8,10,80,2,5,1,4,1,10,5,0,"Matches","https://fbref.com/en/comps/9/2023-2024/defense/2023-2024-Premier-League-Stats"
376,"Zack Nelson","/en/players/de0abf23/Zack-Nelson","eng ENG","MF,DF","Luton Town",18,2004,0.1,1,0,1,0,0,0,0,NA,0,0,0,0,0,1,0,0,"Matches","https://fbref.com/en/comps/9/2023-2024/defense/2023-2024-Premier-League-Stats"
377,"Neto","/en/players/a9dc785c/Neto","br BRA","GK","Bournemouth",34,1989,32,0,0,0,0,0,0,0,NA,0,1,0,1,1,1,12,3,"Matches","https://fbref.com/en/comps/9/2023-2024/defense/2023-2024-Premier-League-Stats"
378,"Pedro Neto","/en/players/7ba2eaa9/Pedro-Neto","pt POR","FW,MF","Wolves",23,2000,16.8,7,3,3,2,2,5,15,33.3,10,5,1,4,5,12,2,0,"Matches","https://fbref.com/en/comps/9/2023-2024/defense/2023-2024-Premier-League-Stats"
379,"Moussa Niakhate","/en/players/00242715/Moussa-Niakhate","sn SEN","DF","Nott'ham Forest",27,1996,16.2,42,25,33,9,0,20,25,80,5,19,12,7,14,56,51,0,"Matches","https://fbref.com/en/comps/9/2023-2024/defense/2023-2024-Premier-League-Stats"
380,"Eddie Nketiah","/en/players/a53649b7/Eddie-Nketiah","eng ENG","FW","Arsenal",24,1999,12,12,7,2,6,4,2,7,28.6,5,11,0,11,4,16,4,0,"Matches","https://fbref.com/en/comps/9/2023-2024/defense/2023-2024-Premier-League-Stats"
381,"Christopher Nkunku","/en/players/7c56da38/Christopher-Nkunku","fr FRA","FW,MF","Chelsea",25,1997,4.9,5,4,0,4,1,1,2,50,1,4,1,3,2,7,4,0,"Matches","https://fbref.com/en/comps/9/2023-2024/defense/2023-2024-Premier-League-Stats"
382,"Rhys Norrington-Davies","/en/players/ca76b087/Rhys-Norrington-Davies","wls WAL","DF","Sheffield Utd",24,1999,1.2,1,1,1,0,0,0,1,0,1,2,0,2,1,2,2,0,"Matches","https://fbref.com/en/comps/9/2023-2024/defense/2023-2024-Premier-League-Stats"
383,"Oliver Norwood","/en/players/43439614/Oliver-Norwood","nir NIR","MF","Sheffield Utd",32,1991,16,41,26,18,18,5,20,47,42.6,27,24,9,15,21,62,39,0,"Matches","https://fbref.com/en/comps/9/2023-2024/defense/2023-2024-Premier-League-Stats"
384,"Matheus Nunes","/en/players/e6af02e0/Matheus-Nunes","pt POR","MF","Wolves",24,1998,2,3,1,3,0,0,2,6,33.3,4,0,0,0,6,9,1,0,"Matches","https://fbref.com/en/comps/9/2023-2024/defense/2023-2024-Premier-League-Stats"
385,"Matheus Nunes","/en/players/e6af02e0/Matheus-Nunes","pt POR","MF","Manchester City",24,1998,7.3,10,4,1,7,2,5,16,31.3,11,7,1,6,1,11,8,1,"Matches","https://fbref.com/en/comps/9/2023-2024/defense/2023-2024-Premier-League-Stats"
386,"Darwin Núñez","/en/players/4d77b365/Darwin-Nunez","uy URU","FW","Liverpool",24,1999,22.7,22,12,2,10,10,11,23,47.8,12,18,6,12,3,25,9,0,"Matches","https://fbref.com/en/comps/9/2023-2024/defense/2023-2024-Premier-League-Stats"
387,"Ethan Nwaneri","/en/players/7f94982c/Ethan-Nwaneri","eng ENG","FW","Arsenal",16,2007,0.2,0,0,0,0,0,0,0,NA,0,1,0,1,0,0,0,0,"Matches","https://fbref.com/en/comps/9/2023-2024/defense/2023-2024-Premier-League-Stats"
388,"Christian Nørgaard","/en/players/df0a4c90/Christian-Norgaard","dk DEN","MF","Brentford",29,1994,27.8,81,50,42,31,8,32,87,36.8,55,48,6,42,54,135,50,0,"Matches","https://fbref.com/en/comps/9/2023-2024/defense/2023-2024-Premier-League-Stats"
389,"Mark O'Mahony","/en/players/a3afdd69/Mark-OMahony","ie IRL","FW","Brighton",18,2005,0.7,1,0,1,0,0,1,2,50,1,2,1,1,0,1,1,0,"Matches","https://fbref.com/en/comps/9/2023-2024/defense/2023-2024-Premier-League-Stats"
390,"Dara O'Shea","/en/players/1d042188/Dara-OShea","ie IRL","DF","Burnley",24,1999,32.1,39,20,22,14,3,11,26,42.3,15,41,30,11,35,74,158,2,"Matches","https://fbref.com/en/comps/9/2023-2024/defense/2023-2024-Premier-League-Stats"
391,"Michael Obafemi","/en/players/caa1a7f0/Michael-Obafemi","ie IRL","FW,MF","Burnley",23,2000,0.2,0,0,0,0,0,0,0,NA,0,1,0,1,0,0,0,0,"Matches","https://fbref.com/en/comps/9/2023-2024/defense/2023-2024-Premier-League-Stats"
392,"Wilson Odobert","/en/players/35516eac/Wilson-Odobert","fr FRA","MF,FW","Burnley",18,2004,23.3,17,13,8,5,4,6,22,27.3,16,26,2,24,6,23,14,0,"Matches","https://fbref.com/en/comps/9/2023-2024/defense/2023-2024-Premier-League-Stats"
393,"Odeluga Offiah","/en/players/65c3efa2/Odeluga-Offiah","eng ENG","DF","Brighton",20,2002,1.4,1,0,1,0,0,1,1,100,0,0,0,0,1,2,0,0,"Matches","https://fbref.com/en/comps/9/2023-2024/defense/2023-2024-Premier-League-Stats"
394,"Chiedozie Ogbene","/en/players/788c0277/Chiedozie-Ogbene","ie IRL","MF,DF","Luton Town",26,1997,22.2,17,10,10,7,0,12,22,54.5,10,14,3,11,7,24,34,2,"Matches","https://fbref.com/en/comps/9/2023-2024/defense/2023-2024-Premier-League-Stats"
395,"Angelo Ogbonna","/en/players/74b2cd7e/Angelo-Ogbonna","it ITA","DF","West Ham",35,1988,7.1,11,5,9,2,0,6,7,85.7,1,13,10,3,3,14,29,0,"Matches","https://fbref.com/en/comps/9/2023-2024/defense/2023-2024-Premier-League-Stats"
396,"Michael Olakigbe","/en/players/cdd70dc0/Michael-Olakigbe","eng ENG","DF,FW","Brentford",19,2004,0.7,3,0,2,1,0,2,4,50,2,7,0,7,1,4,0,1,"Matches","https://fbref.com/en/comps/9/2023-2024/defense/2023-2024-Premier-League-Stats"
397,"Michael Olise","/en/players/c4486bac/Michael-Olise","fr FRA","FW,MF","Crystal Palace",21,2001,14.2,19,10,7,10,2,8,24,33.3,16,21,0,21,11,30,9,0,"Matches","https://fbref.com/en/comps/9/2023-2024/defense/2023-2024-Premier-League-Stats"
398,"Robin Olsen","/en/players/e7ee38c3/Robin-Olsen","se SWE","GK","Aston Villa",33,1990,4.5,0,0,0,0,0,0,0,NA,0,0,0,0,0,0,1,0,"Matches","https://fbref.com/en/comps/9/2023-2024/defense/2023-2024-Premier-League-Stats"
399,"Andrew Omobamidele","/en/players/c393a6c4/Andrew-Omobamidele","ie IRL","DF","Nott'ham Forest",21,2002,8.7,10,3,9,1,0,5,8,62.5,3,12,8,4,13,23,42,1,"Matches","https://fbref.com/en/comps/9/2023-2024/defense/2023-2024-Premier-League-Stats"
400,"Amadou Onana","/en/players/828657ff/Amadou-Onana","be BEL","MF","Everton",21,2001,23.2,71,38,32,31,8,21,42,50,21,25,6,19,21,92,31,0,"Matches","https://fbref.com/en/comps/9/2023-2024/defense/2023-2024-Premier-League-Stats"
401,"André Onana","/en/players/e9c0c1b2/Andre-Onana","cm CMR","GK","Manchester Utd",27,1996,38,2,0,2,0,0,2,2,100,0,0,0,0,0,2,11,2,"Matches","https://fbref.com/en/comps/9/2023-2024/defense/2023-2024-Premier-League-Stats"
402,"Ryan One","/en/players/d4aa4582/Ryan-One","sct SCO","FW","Sheffield Utd",17,2006,0.1,0,0,0,0,0,0,0,NA,0,0,0,0,0,0,0,0,"Matches","https://fbref.com/en/comps/9/2023-2024/defense/2023-2024-Premier-League-Stats"
403,"Tyler Onyango","/en/players/d86a1f3e/Tyler-Onyango","eng ENG","MF","Everton",20,2003,0,0,0,0,0,0,0,0,NA,0,0,0,0,0,0,0,0,"Matches","https://fbref.com/en/comps/9/2023-2024/defense/2023-2024-Premier-League-Stats"
404,"Fred Onyedinma","/en/players/387d06b2/Fred-Onyedinma","eng ENG","DF,MF","Luton Town",26,1996,4.5,10,6,7,3,0,5,12,41.7,7,3,0,3,1,11,13,0,"Matches","https://fbref.com/en/comps/9/2023-2024/defense/2023-2024-Premier-League-Stats"
405,"Frank Onyeka","/en/players/2944f86f/Frank-Onyeka","ng NGA","MF","Brentford",25,1998,12.9,37,24,9,23,5,16,29,55.2,13,15,7,8,23,60,17,0,"Matches","https://fbref.com/en/comps/9/2023-2024/defense/2023-2024-Premier-League-Stats"
406,"Divock Origi","/en/players/43a166b4/Divock-Origi","be BEL","FW","Nott'ham Forest",28,1995,6.7,6,4,5,0,1,0,0,NA,0,6,0,6,2,8,4,0,"Matches","https://fbref.com/en/comps/9/2023-2024/defense/2023-2024-Premier-League-Stats"
407,"Stefan Ortega","/en/players/c1242d4e/Stefan-Ortega","de GER","GK","Manchester City",30,1992,7.1,0,0,0,0,0,0,0,NA,0,0,0,0,0,0,2,1,"Matches","https://fbref.com/en/comps/9/2023-2024/defense/2023-2024-Premier-League-Stats"
408,"Ben Osborn","/en/players/79bc4c45/Ben-Osborn","eng ENG","DF,MF","Sheffield Utd",28,1994,15.2,22,9,11,9,2,8,17,47.1,9,18,2,16,8,30,30,0,"Matches","https://fbref.com/en/comps/9/2023-2024/defense/2023-2024-Premier-League-Stats"
409,"Gabriel Osho","/en/players/cd889153/Gabriel-Osho","ng NGA","DF","Luton Town",24,1998,20.5,41,22,21,19,1,16,27,59.3,11,37,20,17,31,72,92,0,"Matches","https://fbref.com/en/comps/9/2023-2024/defense/2023-2024-Premier-League-Stats"
410,"William Osula","/en/players/7b355808/William-Osula","dk DEN","FW","Sheffield Utd",19,2003,8.7,2,2,1,0,1,1,2,50,1,3,1,2,2,4,9,0,"Matches","https://fbref.com/en/comps/9/2023-2024/defense/2023-2024-Premier-League-Stats"
411,"Dango Ouattara","/en/players/2f9e4435/Dango-Ouattara","bf BFA","FW,DF","Bournemouth",21,2002,13.7,45,27,22,11,12,19,34,55.9,15,18,3,15,22,67,35,0,"Matches","https://fbref.com/en/comps/9/2023-2024/defense/2023-2024-Premier-League-Stats"
412,"David Ozoh","/en/players/d00d45ab/David-Ozoh","eng ENG","MF,DF","Crystal Palace",18,2005,1.7,10,6,3,6,1,5,6,83.3,1,2,0,2,0,10,2,0,"Matches","https://fbref.com/en/comps/9/2023-2024/defense/2023-2024-Premier-League-Stats"
413,"João Palhinha","/en/players/a78ff07f/Joao-Palhinha","pt POR","MF","Fulham",28,1995,30,152,75,80,60,12,103,152,67.8,49,57,9,48,46,198,58,0,"Matches","https://fbref.com/en/comps/9/2023-2024/defense/2023-2024-Premier-League-Stats"
414,"Cole Palmer","/en/players/dc7f8a28/Cole-Palmer","eng ENG","FW,MF","Chelsea",21,2002,29,23,12,9,6,8,8,19,42.1,11,20,2,18,20,43,13,2,"Matches","https://fbref.com/en/comps/9/2023-2024/defense/2023-2024-Premier-League-Stats"
415,"Cole Palmer","/en/players/dc7f8a28/Cole-Palmer","eng ENG","MF","Manchester City",21,2002,0.1,0,0,0,0,0,0,0,NA,0,0,0,0,0,0,0,0,"Matches","https://fbref.com/en/comps/9/2023-2024/defense/2023-2024-Premier-League-Stats"
416,"Emerson Palmieri","/en/players/e0bc6fdc/Emerson-Palmieri","it ITA","DF","West Ham",28,1994,34.9,106,68,48,42,16,57,90,63.3,33,47,15,32,43,149,96,0,"Matches","https://fbref.com/en/comps/9/2023-2024/defense/2023-2024-Premier-League-Stats"
417,"Lucas Paquetá","/en/players/9b6f7fd5/Lucas-Paqueta","br BRA","FW,MF","West Ham",25,1997,29.1,71,48,38,26,7,25,52,48.1,27,28,1,27,21,92,28,2,"Matches","https://fbref.com/en/comps/9/2023-2024/defense/2023-2024-Premier-League-Stats"
418,"Ben Parkinson","/en/players/32163807/Ben-Parkinson","eng ENG","FW","Newcastle Utd",18,2005,0.3,0,0,0,0,0,0,0,NA,0,1,0,1,0,0,1,0,"Matches","https://fbref.com/en/comps/9/2023-2024/defense/2023-2024-Premier-League-Stats"
419,"Thomas Partey","/en/players/529f49ab/Thomas-Partey","gh GHA","MF,DF","Arsenal",30,1993,8.8,14,11,9,4,1,5,10,50,5,9,3,6,11,25,9,0,"Matches","https://fbref.com/en/comps/9/2023-2024/defense/2023-2024-Premier-League-Stats"
420,"Nathan Patterson","/en/players/230f0471/Nathan-Patterson","sct SCO","DF","Everton",21,2001,11.2,34,24,21,11,2,14,37,37.8,23,14,3,11,9,43,33,0,"Matches","https://fbref.com/en/comps/9/2023-2024/defense/2023-2024-Premier-League-Stats"
421,"Myles Peart-Harris","/en/players/ea1a5662/Myles-Peart-Harris","eng ENG","DF,MF","Brentford",20,2002,0.1,0,0,0,0,0,0,0,NA,0,0,0,0,0,0,1,0,"Matches","https://fbref.com/en/comps/9/2023-2024/defense/2023-2024-Premier-League-Stats"
422,"Sydie Peck","/en/players/767d9605/Sydie-Peck","eng ENG","MF","Sheffield Utd",18,2004,0.1,0,0,0,0,0,0,0,NA,0,0,0,0,0,0,0,0,"Matches","https://fbref.com/en/comps/9/2023-2024/defense/2023-2024-Premier-League-Stats"
423,"Facundo Pellistri","/en/players/ac7e7b1c/Facundo-Pellistri","uy URU","FW,MF","Manchester Utd",21,2001,1.9,5,3,4,1,0,1,3,33.3,2,7,1,6,1,6,5,0,"Matches","https://fbref.com/en/comps/9/2023-2024/defense/2023-2024-Premier-League-Stats"
424,"Andreas Pereira","/en/players/6639e500/Andreas-Pereira","br BRA","MF","Fulham",27,1996,29,25,12,4,12,9,11,41,26.8,30,16,2,14,4,29,12,0,"Matches","https://fbref.com/en/comps/9/2023-2024/defense/2023-2024-Premier-League-Stats"
425,"Ivan Perišić","/en/players/6fe90922/Ivan-Perisic","hr CRO","FW","Tottenham",34,1989,1.1,3,2,1,1,1,3,5,60,2,1,0,1,2,5,1,0,"Matches","https://fbref.com/en/comps/9/2023-2024/defense/2023-2024-Premier-League-Stats"
426,"Đorđe Petrović","/en/players/0cf321c8/Djordje-Petrovic","rs SRB","GK","Chelsea",23,1999,22.1,0,0,0,0,0,0,0,NA,0,0,0,0,0,0,12,3,"Matches","https://fbref.com/en/comps/9/2023-2024/defense/2023-2024-Premier-League-Stats"
427,"Kalvin Phillips","/en/players/4f565d77/Kalvin-Phillips","eng ENG","MF","West Ham",27,1995,3.4,11,6,2,8,1,5,9,55.6,4,4,1,3,4,15,2,1,"Matches","https://fbref.com/en/comps/9/2023-2024/defense/2023-2024-Premier-League-Stats"
428,"Kalvin Phillips","/en/players/4f565d77/Kalvin-Phillips","eng ENG","MF","Manchester City",27,1995,1,3,3,1,1,1,0,0,NA,0,0,0,0,2,5,2,0,"Matches","https://fbref.com/en/comps/9/2023-2024/defense/2023-2024-Premier-League-Stats"
429,"Jaden Philogene Bidace","/en/players/19f4d211/Jaden-Philogene-Bidace","eng ENG","FW","Aston Villa",21,2002,0,0,0,0,0,0,0,0,NA,0,0,0,0,0,0,0,0,"Matches","https://fbref.com/en/comps/9/2023-2024/defense/2023-2024-Premier-League-Stats"
430,"Jordan Pickford","/en/players/4806ec67/Jordan-Pickford","eng ENG","GK","Everton",29,1994,38,1,0,1,0,0,1,1,100,0,3,0,3,0,1,19,1,"Matches","https://fbref.com/en/comps/9/2023-2024/defense/2023-2024-Premier-League-Stats"
431,"Ethan Pinnock","/en/players/e541326e/Ethan-Pinnock","jm JAM","DF","Brentford",30,1993,28,35,23,22,13,0,9,20,45,11,40,24,16,43,78,170,3,"Matches","https://fbref.com/en/comps/9/2023-2024/defense/2023-2024-Premier-League-Stats"
432,"Nick Pope","/en/players/4b40d9ca/Nick-Pope","eng ENG","GK","Newcastle Utd",31,1992,14.9,0,0,0,0,0,0,1,0,1,0,0,0,0,0,7,2,"Matches","https://fbref.com/en/comps/9/2023-2024/defense/2023-2024-Premier-League-Stats"
433,"Pedro Porro","/en/players/27d0a506/Pedro-Porro","es ESP","DF","Tottenham",23,1999,34.3,91,63,43,34,14,62,120,51.7,58,63,18,45,34,125,102,3,"Matches","https://fbref.com/en/comps/9/2023-2024/defense/2023-2024-Premier-League-Stats"
434,"Jarell Quansah","/en/players/4125cb98/Jarell-Quansah","eng ENG","DF","Liverpool",20,2003,13.2,25,22,17,7,1,14,20,70,6,16,8,8,17,42,39,1,"Matches","https://fbref.com/en/comps/9/2023-2024/defense/2023-2024-Premier-League-Stats"
435,"Ionuț Radu","/en/players/67f649be/Ionut-Radu","ro ROU","GK","Bournemouth",26,1997,2,0,0,0,0,0,0,0,NA,0,0,0,0,0,0,0,0,"Matches","https://fbref.com/en/comps/9/2023-2024/defense/2023-2024-Premier-League-Stats"
436,"Jesurun Rak Sakyi","/en/players/45685411/Jesurun-Rak-Sakyi","eng ENG","MF,FW","Crystal Palace",20,2002,1.5,4,1,3,1,0,2,3,66.7,1,2,0,2,3,7,1,0,"Matches","https://fbref.com/en/comps/9/2023-2024/defense/2023-2024-Premier-League-Stats"
437,"Aaron Ramsdale","/en/players/466fb2c5/Aaron-Ramsdale","eng ENG","GK","Arsenal",25,1998,6,0,0,0,0,0,0,0,NA,0,0,0,0,0,0,3,2,"Matches","https://fbref.com/en/comps/9/2023-2024/defense/2023-2024-Premier-League-Stats"
438,"Aaron Ramsey","/en/players/e1618c22/Aaron-Ramsey","eng ENG","MF,FW","Burnley",20,2003,5.9,17,14,7,5,5,8,16,50,8,11,2,9,1,18,10,0,"Matches","https://fbref.com/en/comps/9/2023-2024/defense/2023-2024-Premier-League-Stats"
439,"Jacob Ramsey","/en/players/1544f145/Jacob-Ramsey","eng ENG","FW,MF","Aston Villa",22,2001,9.5,16,8,7,6,3,5,15,33.3,10,15,2,13,3,19,8,0,"Matches","https://fbref.com/en/comps/9/2023-2024/defense/2023-2024-Premier-League-Stats"
440,"Marcus Rashford","/en/players/a1d5bd30/Marcus-Rashford","eng ENG","FW","Manchester Utd",25,1997,25.2,19,12,9,4,6,9,26,34.6,17,15,1,14,4,23,21,0,"Matches","https://fbref.com/en/comps/9/2023-2024/defense/2023-2024-Premier-League-Stats"
441,"David Raya","/en/players/98ea5115/David-Raya","es ESP","GK","Arsenal",27,1995,32,1,1,1,0,0,1,1,100,0,0,0,0,0,1,8,5,"Matches","https://fbref.com/en/comps/9/2023-2024/defense/2023-2024-Premier-League-Stats"
442,"Tim Ream","/en/players/28b40c9c/Tim-Ream","us USA","DF","Fulham",35,1987,16.7,20,9,13,5,2,9,18,50,9,23,15,8,25,45,61,2,"Matches","https://fbref.com/en/comps/9/2023-2024/defense/2023-2024-Premier-League-Stats"
443,"Nathan Redmond","/en/players/ab651565/Nathan-Redmond","eng ENG","FW,MF","Burnley",29,1994,1.6,2,1,0,0,2,1,4,25,3,1,0,1,0,2,3,0,"Matches","https://fbref.com/en/comps/9/2023-2024/defense/2023-2024-Premier-League-Stats"
444,"Harrison Reed","/en/players/803ae100/Harrison-Reed","eng ENG","MF","Fulham",28,1995,14.7,29,18,9,17,3,13,31,41.9,18,19,9,10,11,40,24,0,"Matches","https://fbref.com/en/comps/9/2023-2024/defense/2023-2024-Premier-League-Stats"
445,"Sergio Reguilón","/en/players/3353737a/Sergio-Reguilon","es ESP","DF","Manchester Utd",26,1996,4.6,13,8,6,2,5,8,17,47.1,9,10,0,10,5,18,7,0,"Matches","https://fbref.com/en/comps/9/2023-2024/defense/2023-2024-Premier-League-Stats"
446,"Sergio Reguilón","/en/players/3353737a/Sergio-Reguilon","es ESP","DF","Brentford",26,1996,12.4,45,20,26,18,1,24,40,60,16,23,6,17,16,61,41,1,"Matches","https://fbref.com/en/comps/9/2023-2024/defense/2023-2024-Premier-League-Stats"
447,"Bobby Reid","/en/players/0f7533cd/Bobby-Reid","jm JAM","FW","Fulham",30,1993,15.8,22,14,5,15,2,4,16,25,12,24,2,22,5,27,14,0,"Matches","https://fbref.com/en/comps/9/2023-2024/defense/2023-2024-Premier-League-Stats"
448,"Gio Reyna","/en/players/7fa4e703/Gio-Reyna","us USA","FW,MF","Nott'ham Forest",20,2002,2.6,7,3,4,0,3,3,6,50,3,3,0,3,2,9,0,0,"Matches","https://fbref.com/en/comps/9/2023-2024/defense/2023-2024-Premier-League-Stats"
449,"Rodrigo Ribeiro","/en/players/484a3eae/Rodrigo-Ribeiro","pt POR","MF,FW","Nott'ham Forest",18,2005,0.2,0,0,0,0,0,0,1,0,1,1,0,1,1,1,0,0,"Matches","https://fbref.com/en/comps/9/2023-2024/defense/2023-2024-Premier-League-Stats"
450,"Declan Rice","/en/players/1c7012b8/Declan-Rice","eng ENG","MF","Arsenal",24,1999,35.8,83,51,37,38,8,32,57,56.1,25,37,11,26,44,127,52,0,"Matches","https://fbref.com/en/comps/9/2023-2024/defense/2023-2024-Premier-League-Stats"
451,"Chris Richards","/en/players/0a3d6d2b/Chris-Richards","us USA","DF,MF","Crystal Palace",23,2000,23.3,46,28,21,22,3,20,30,66.7,10,32,12,20,27,73,109,0,"Matches","https://fbref.com/en/comps/9/2023-2024/defense/2023-2024-Premier-League-Stats"
452,"Richarlison","/en/players/fa031b34/Richarlison","br BRA","FW","Tottenham",26,1997,16.6,16,11,4,8,4,2,10,20,8,32,6,26,8,24,23,0,"Matches","https://fbref.com/en/comps/9/2023-2024/defense/2023-2024-Premier-League-Stats"
453,"Jaïro Riedewald","/en/players/7a1f2c08/Jairo-Riedewald","nl NED","MF,FW","Crystal Palace",26,1996,2.6,9,3,2,4,3,3,6,50,3,0,0,0,2,11,2,0,"Matches","https://fbref.com/en/comps/9/2023-2024/defense/2023-2024-Premier-League-Stats"
454,"Matt Ritchie","/en/players/71ef519e/Matt-Ritchie","sct SCO","FW,MF","Newcastle Utd",33,1989,1.4,5,3,2,2,1,2,4,50,2,3,2,1,1,6,5,0,"Matches","https://fbref.com/en/comps/9/2023-2024/defense/2023-2024-Premier-League-Stats"
455,"Connor Roberts","/en/players/24fae784/Connor-Roberts","wls WAL","DF","Burnley",27,1995,9.1,12,5,6,4,2,8,17,47.1,9,8,6,2,4,16,25,2,"Matches","https://fbref.com/en/comps/9/2023-2024/defense/2023-2024-Premier-League-Stats"
456,"Andrew Robertson","/en/players/2e4f5f03/Andrew-Robertson","sct SCO","DF","Liverpool",29,1994,18.8,35,24,21,11,3,26,43,60.5,17,20,6,14,13,48,40,0,"Matches","https://fbref.com/en/comps/9/2023-2024/defense/2023-2024-Premier-League-Stats"
457,"Antonee Robinson","/en/players/289601e6/Antonee-Robinson","us USA","DF","Fulham",25,1997,36.3,93,58,60,26,7,52,110,47.3,58,56,8,48,80,173,117,3,"Matches","https://fbref.com/en/comps/9/2023-2024/defense/2023-2024-Premier-League-Stats"
458,"Jack Robinson","/en/players/7399c7a8/Jack-Robinson","eng ENG","DF","Sheffield Utd",29,1993,32.1,43,28,29,14,0,25,39,64.1,14,49,33,16,33,76,132,2,"Matches","https://fbref.com/en/comps/9/2023-2024/defense/2023-2024-Premier-League-Stats"
459,"Rodri","/en/players/6434f10d/Rodri","es ESP","MF","Manchester City",27,1996,32.6,70,43,25,33,12,29,60,48.3,31,32,8,24,26,96,41,4,"Matches","https://fbref.com/en/comps/9/2023-2024/defense/2023-2024-Premier-League-Stats"
460,"Jay Rodriguez","/en/players/4ab53cdb/Jay-Rodriguez","eng ENG","FW","Burnley",34,1989,9.1,14,9,7,4,3,7,13,53.8,6,11,1,10,1,15,8,0,"Matches","https://fbref.com/en/comps/9/2023-2024/defense/2023-2024-Premier-League-Stats"
461,"Mads Roerslev","/en/players/57c94db2/Mads-Roerslev","dk DEN","DF","Brentford",24,1999,22.1,48,31,34,9,5,27,54,50,27,15,3,12,19,67,71,0,"Matches","https://fbref.com/en/comps/9/2023-2024/defense/2023-2024-Premier-League-Stats"
462,"Morgan Rogers","/en/players/2e5915f1/Morgan-Rogers","eng ENG","MF,FW","Aston Villa",21,2002,7.1,8,1,3,2,3,2,11,18.2,9,11,0,11,3,11,11,0,"Matches","https://fbref.com/en/comps/9/2023-2024/defense/2023-2024-Premier-League-Stats"
463,"Cristian Romero","/en/players/a3d94a58/Cristian-Romero","ar ARG","DF","Tottenham",25,1998,31,66,40,35,25,6,32,44,72.7,12,46,22,24,44,110,106,1,"Matches","https://fbref.com/en/comps/9/2023-2024/defense/2023-2024-Premier-League-Stats"
464,"Joe Rothwell","/en/players/10a10454/Joe-Rothwell","eng ENG","MF","Bournemouth",28,1995,4.3,7,2,4,2,1,2,8,25,6,4,2,2,3,10,2,0,"Matches","https://fbref.com/en/comps/9/2023-2024/defense/2023-2024-Premier-League-Stats"
465,"Pelly Ruddock Mpanzu","/en/players/a9b1c319/Pelly-Ruddock-Mpanzu","cd COD","MF","Luton Town",30,1993,12.2,13,5,6,6,1,5,9,55.6,4,15,7,8,9,22,16,3,"Matches","https://fbref.com/en/comps/9/2023-2024/defense/2023-2024-Premier-League-Stats"
466,"José Sá","/en/players/903b6e8b/Jose-Sa","pt POR","GK","Wolves",30,1993,33.7,0,0,0,0,0,0,1,0,1,3,0,3,0,0,21,5,"Matches","https://fbref.com/en/comps/9/2023-2024/defense/2023-2024-Premier-League-Stats"
467,"Dominic Sadi","/en/players/54778940/Dominic-Sadi","eng ENG","FW","Bournemouth",19,2003,0,0,0,0,0,0,0,0,NA,0,0,0,0,0,0,0,0,"Matches","https://fbref.com/en/comps/9/2023-2024/defense/2023-2024-Premier-League-Stats"
468,"Bukayo Saka","/en/players/bc7dc64d/Bukayo-Saka","eng ENG","FW","Arsenal",21,2001,32.4,66,35,22,24,20,26,59,44.1,33,43,2,41,15,81,24,1,"Matches","https://fbref.com/en/comps/9/2023-2024/defense/2023-2024-Premier-League-Stats"
469,"Mohamed Salah","/en/players/e342ad68/Mohamed-Salah","eg EGY","FW","Liverpool",31,1992,28.2,17,11,1,8,8,6,21,28.6,15,19,1,18,2,19,1,0,"Matches","https://fbref.com/en/comps/9/2023-2024/defense/2023-2024-Premier-League-Stats"
470,"William Saliba","/en/players/972aeb2a/William-Saliba","fr FRA","DF","Arsenal",22,2001,38,41,26,28,12,1,20,27,74.1,7,32,17,15,29,70,81,3,"Matches","https://fbref.com/en/comps/9/2023-2024/defense/2023-2024-Premier-League-Stats"
471,"Albert Sambi Lokonga","/en/players/1b4f1169/Albert-Sambi-Lokonga","be BEL","MF","Luton Town",23,1999,14.5,29,18,14,12,3,17,24,70.8,7,23,13,10,11,40,14,0,"Matches","https://fbref.com/en/comps/9/2023-2024/defense/2023-2024-Premier-League-Stats"
472,"Davinson Sánchez","/en/players/da7b447d/Davinson-Sanchez","co COL","DF","Tottenham",27,1996,0.9,0,0,0,0,0,0,0,NA,0,3,2,1,1,1,2,0,"Matches","https://fbref.com/en/comps/9/2023-2024/defense/2023-2024-Premier-League-Stats"
473,"Robert Sánchez","/en/players/6a713852/Robert-Sanchez","es ESP","GK","Chelsea",25,1997,15.9,0,0,0,0,0,0,0,NA,0,0,0,0,0,0,11,3,"Matches","https://fbref.com/en/comps/9/2023-2024/defense/2023-2024-Premier-League-Stats"
474,"Jadon Sancho","/en/players/dbf053da/Jadon-Sancho","eng ENG","FW,MF","Manchester Utd",23,2000,0.9,1,0,1,0,0,1,3,33.3,2,1,0,1,1,2,0,0,"Matches","https://fbref.com/en/comps/9/2023-2024/defense/2023-2024-Premier-League-Stats"
475,"Ibrahim Sangaré","/en/players/bced0375/Ibrahim-Sangare","ci CIV","MF","Nott'ham Forest",25,1997,11.5,42,23,25,13,4,12,29,41.4,17,24,7,17,16,58,21,0,"Matches","https://fbref.com/en/comps/9/2023-2024/defense/2023-2024-Premier-League-Stats"
476,"Andrey Santos","/en/players/dd745366/Andrey-Santos","br BRA","MF","Nott'ham Forest",19,2004,0.1,0,0,0,0,0,0,0,NA,0,1,0,1,0,0,0,0,"Matches","https://fbref.com/en/comps/9/2023-2024/defense/2023-2024-Premier-League-Stats"
477,"Pablo Sarabia","/en/players/9744ff80/Pablo-Sarabia","es ESP","MF,FW","Wolves",31,1992,19.4,20,13,8,8,4,12,36,33.3,24,17,1,16,10,30,9,0,"Matches","https://fbref.com/en/comps/9/2023-2024/defense/2023-2024-Premier-League-Stats"
478,"Dane Scarlett","/en/players/21945a9e/Dane-Scarlett","eng ENG","FW","Tottenham",19,2004,0.2,1,1,0,0,1,0,1,0,1,0,0,0,0,1,0,0,"Matches","https://fbref.com/en/comps/9/2023-2024/defense/2023-2024-Premier-League-Stats"
479,"Kevin Schade","/en/players/52afb588/Kevin-Schade","de GER","FW,MF","Brentford",21,2001,3.7,3,1,1,2,0,0,5,0,5,2,0,2,1,4,4,0,"Matches","https://fbref.com/en/comps/9/2023-2024/defense/2023-2024-Premier-League-Stats"
480,"Fabian Schär","/en/players/c8aa95da/Fabian-Schar","ch SUI","DF","Newcastle Utd",31,1991,33.9,42,24,27,13,2,18,40,45,22,50,38,12,36,78,133,1,"Matches","https://fbref.com/en/comps/9/2023-2024/defense/2023-2024-Premier-League-Stats"
481,"Jeffrey Schlupp","/en/players/3312f911/Jeffrey-Schlupp","gh GHA","FW,MF","Crystal Palace",30,1992,15,38,24,14,16,8,9,18,50,9,13,2,11,8,46,24,0,"Matches","https://fbref.com/en/comps/9/2023-2024/defense/2023-2024-Premier-League-Stats"
482,"Alex Scott","/en/players/104d0bb8/Alex-Scott","eng ENG","MF","Bournemouth",19,2003,11.3,24,15,8,10,6,12,28,42.9,16,14,4,10,12,36,18,2,"Matches","https://fbref.com/en/comps/9/2023-2024/defense/2023-2024-Premier-League-Stats"
483,"Matz Sels","/en/players/834b5c4c/Matz-Sels","be BEL","GK","Nott'ham Forest",31,1992,16,0,0,0,0,0,0,0,NA,0,0,0,0,0,0,11,1,"Matches","https://fbref.com/en/comps/9/2023-2024/defense/2023-2024-Premier-League-Stats"
484,"Nélson Semedo","/en/players/d04b94db/Nelson-Semedo","pt POR","DF,MF","Wolves",29,1993,34.3,79,48,52,19,8,38,64,59.4,26,44,8,36,36,115,85,1,"Matches","https://fbref.com/en/comps/9/2023-2024/defense/2023-2024-Premier-League-Stats"
485,"Antoine Semenyo","/en/players/efd2ec23/Antoine-Semenyo","gh GHA","FW","Bournemouth",23,2000,23.4,24,17,7,9,8,9,27,33.3,18,39,2,37,6,30,21,0,"Matches","https://fbref.com/en/comps/9/2023-2024/defense/2023-2024-Premier-League-Stats"
486,"Marcos Senesi","/en/players/35141f4c/Marcos-Senesi","ar ARG","DF","Bournemouth",26,1997,24.9,55,32,28,23,4,24,56,42.9,32,50,23,27,35,90,109,1,"Matches","https://fbref.com/en/comps/9/2023-2024/defense/2023-2024-Premier-League-Stats"
487,"Luke Shaw","/en/players/9c94165b/Luke-Shaw","eng ENG","DF","Manchester Utd",28,1995,10.7,11,8,7,3,1,9,15,60,6,18,11,7,6,17,39,0,"Matches","https://fbref.com/en/comps/9/2023-2024/defense/2023-2024-Premier-League-Stats"
488,"James Shea","/en/players/ee7c0a5e/James-Shea","eng ENG","GK","Luton Town",32,1991,0.2,0,0,0,0,0,0,0,NA,0,0,0,0,0,0,2,0,"Matches","https://fbref.com/en/comps/9/2023-2024/defense/2023-2024-Premier-League-Stats"
489,"Bernardo Silva","/en/players/3eb22ec9/Bernardo-Silva","pt POR","MF,FW","Manchester City",28,1994,28.6,51,23,13,25,13,25,57,43.9,32,32,4,28,17,68,15,1,"Matches","https://fbref.com/en/comps/9/2023-2024/defense/2023-2024-Premier-League-Stats"
490,"Fábio Silva","/en/players/e7aa9d7c/Fabio-Silva","pt POR","FW","Wolves",21,2002,2.9,7,4,3,4,0,2,3,66.7,1,1,0,1,2,9,0,0,"Matches","https://fbref.com/en/comps/9/2023-2024/defense/2023-2024-Premier-League-Stats"
491,"Thiago Silva","/en/players/86e7deaf/Thiago-Silva","br BRA","DF","Chelsea",38,1984,28.1,29,15,22,6,1,20,34,58.8,14,33,24,9,26,55,153,4,"Matches","https://fbref.com/en/comps/9/2023-2024/defense/2023-2024-Premier-League-Stats"
492,"Luis Sinisterra","/en/players/8e16dd48/Luis-Sinisterra","co COL","FW,MF","Bournemouth",24,1999,7.8,23,12,9,10,4,9,16,56.3,7,18,0,18,8,31,4,0,"Matches","https://fbref.com/en/comps/9/2023-2024/defense/2023-2024-Premier-League-Stats"
493,"Oliver Skipp","/en/players/6250083a/Oliver-Skipp","eng ENG","MF,DF","Tottenham",22,2000,7.9,18,12,9,6,3,11,18,61.1,7,12,1,11,3,21,9,0,"Matches","https://fbref.com/en/comps/9/2023-2024/defense/2023-2024-Premier-League-Stats"
494,"Adam Smith","/en/players/20b104bc/Adam-Smith","eng ENG","DF","Bournemouth",32,1991,23.9,37,23,18,11,8,19,39,48.7,20,28,11,17,21,58,62,0,"Matches","https://fbref.com/en/comps/9/2023-2024/defense/2023-2024-Premier-League-Stats"
495,"Emile Smith Rowe","/en/players/17695062/Emile-Smith-Rowe","eng ENG","MF","Arsenal",23,2000,3.9,4,1,2,2,0,2,4,50,2,3,1,2,3,7,1,0,"Matches","https://fbref.com/en/comps/9/2023-2024/defense/2023-2024-Premier-League-Stats"
496,"Cédric Soares","/en/players/839c14e1/Cedric-Soares","pt POR","DF","Arsenal",31,1991,0.7,0,0,0,0,0,0,0,NA,0,0,0,0,0,0,0,0,"Matches","https://fbref.com/en/comps/9/2023-2024/defense/2023-2024-Premier-League-Stats"
497,"Dominic Solanke","/en/players/e77dc3b2/Dominic-Solanke","eng ENG","FW","Bournemouth",25,1997,36.9,23,11,3,13,7,10,29,34.5,19,24,5,19,7,30,43,0,"Matches","https://fbref.com/en/comps/9/2023-2024/defense/2023-2024-Premier-League-Stats"
498,"Manor Solomon","/en/players/886f9aac/Manor-Solomon","il ISR","FW","Tottenham",24,1999,2.2,3,3,1,1,1,1,2,50,1,4,0,4,3,6,2,0,"Matches","https://fbref.com/en/comps/9/2023-2024/defense/2023-2024-Premier-League-Stats"
499,"Tomáš Souček","/en/players/6613c819/Tomas-Soucek","cz CZE","MF","West Ham",28,1995,31.9,53,35,24,26,3,21,47,44.7,26,55,28,27,37,90,109,0,"Matches","https://fbref.com/en/comps/9/2023-2024/defense/2023-2024-Premier-League-Stats"
500,"Vinicius Souza","/en/players/6a8a7af8/Vinicius-Souza","br BRA","MF","Sheffield Utd",24,1999,29.6,125,76,59,51,15,41,74,55.4,33,57,17,40,32,157,75,1,"Matches","https://fbref.com/en/comps/9/2023-2024/defense/2023-2024-Premier-League-Stats"
501,"Jason Steele","/en/players/28300a16/Jason-Steele","eng ENG","GK","Brighton",32,1990,17,0,0,0,0,0,0,3,0,3,0,0,0,0,0,8,1,"Matches","https://fbref.com/en/comps/9/2023-2024/defense/2023-2024-Premier-League-Stats"
502,"Raheem Sterling","/en/players/b400bde0/Raheem-Sterling","eng ENG","FW,MF","Chelsea",28,1994,22,21,10,7,8,6,12,26,46.2,14,13,0,13,13,34,9,1,"Matches","https://fbref.com/en/comps/9/2023-2024/defense/2023-2024-Premier-League-Stats"
503,"John Stones","/en/players/5eecec3d/John-Stones","eng ENG","DF,MF","Manchester City",29,1994,11.8,2,1,1,0,1,0,3,0,3,11,7,4,10,12,21,0,"Matches","https://fbref.com/en/comps/9/2023-2024/defense/2023-2024-Premier-League-Stats"
504,"Thomas Strakosha","/en/players/339fe0e8/Thomas-Strakosha","al ALB","GK","Brentford",28,1995,1.5,0,0,0,0,0,0,0,NA,0,0,0,0,0,0,0,0,"Matches","https://fbref.com/en/comps/9/2023-2024/defense/2023-2024-Premier-League-Stats"
505,"Dominik Szoboszlai","/en/players/934e1968/Dominik-Szoboszlai","hu HUN","MF","Liverpool",22,2000,23.4,32,19,12,12,8,16,50,32,34,37,2,35,15,47,16,1,"Matches","https://fbref.com/en/comps/9/2023-2024/defense/2023-2024-Premier-League-Stats"
506,"Matt Targett","/en/players/e514ab62/Matt-Targett","eng ENG","DF","Newcastle Utd",27,1995,0.9,2,0,1,1,0,1,1,100,0,1,0,1,0,2,2,0,"Matches","https://fbref.com/en/comps/9/2023-2024/defense/2023-2024-Premier-League-Stats"
507,"James Tarkowski","/en/players/15ea812b/James-Tarkowski","eng ENG","DF","Everton",30,1992,38,61,42,46,14,1,27,48,56.3,21,82,56,26,56,117,191,2,"Matches","https://fbref.com/en/comps/9/2023-2024/defense/2023-2024-Premier-League-Stats"
508,"Jimi Tauriainen","/en/players/cac9e583/Jimi-Tauriainen","eng ENG","FW","Chelsea",19,2004,0,0,0,0,0,0,0,0,NA,0,0,0,0,0,0,0,0,"Matches","https://fbref.com/en/comps/9/2023-2024/defense/2023-2024-Premier-League-Stats"
509,"Nuno Tavares","/en/players/a65c844b/Nuno-Tavares","pt POR","DF","Nott'ham Forest",23,2000,5.1,11,7,9,1,1,8,9,88.9,1,6,0,6,1,12,21,0,"Matches","https://fbref.com/en/comps/9/2023-2024/defense/2023-2024-Premier-League-Stats"
510,"Marcus Tavernier","/en/players/5c0da4a4/Marcus-Tavernier","eng ENG","FW","Bournemouth",24,1999,23.5,53,34,25,22,6,26,48,54.2,22,31,3,28,5,58,23,0,"Matches","https://fbref.com/en/comps/9/2023-2024/defense/2023-2024-Premier-League-Stats"
511,"Charlie Taylor","/en/players/cc2d7ad5/Charlie-Taylor","eng ENG","DF","Burnley",29,1993,25.9,35,20,19,14,2,17,35,48.6,18,27,11,16,19,54,78,0,"Matches","https://fbref.com/en/comps/9/2023-2024/defense/2023-2024-Premier-League-Stats"
512,"Kenny Tete","/en/players/77d7c96f/Kenny-Tete","nl NED","DF","Fulham",27,1995,9.6,27,17,19,6,2,11,19,57.9,8,10,3,7,16,43,35,0,"Matches","https://fbref.com/en/comps/9/2023-2024/defense/2023-2024-Premier-League-Stats"
513,"Luke Thomas","/en/players/fc027d02/Luke-Thomas","eng ENG","DF","Sheffield Utd",22,2001,10.2,20,9,13,6,1,8,14,57.1,6,23,5,18,10,30,27,0,"Matches","https://fbref.com/en/comps/9/2023-2024/defense/2023-2024-Premier-League-Stats"
514,"Youri Tielemans","/en/players/56f7a928/Youri-Tielemans","be BEL","MF,FW","Aston Villa",26,1997,18,41,20,17,18,6,16,40,40,24,23,3,20,15,56,9,0,"Matches","https://fbref.com/en/comps/9/2023-2024/defense/2023-2024-Premier-League-Stats"
515,"Jurriën Timber","/en/players/41034650/Jurrien-Timber","nl NED","DF","Arsenal",22,2001,0.8,2,2,1,1,0,0,0,NA,0,1,0,1,0,2,1,0,"Matches","https://fbref.com/en/comps/9/2023-2024/defense/2023-2024-Premier-League-Stats"
516,"Harry Toffolo","/en/players/a105d46a/Harry-Toffolo","eng ENG","DF","Nott'ham Forest",27,1995,16.2,26,14,20,6,0,15,24,62.5,9,34,13,21,14,40,49,0,"Matches","https://fbref.com/en/comps/9/2023-2024/defense/2023-2024-Premier-League-Stats"
517,"Takehiro Tomiyasu","/en/players/b3af9be1/Takehiro-Tomiyasu","jp JPN","DF","Arsenal",24,1998,12.8,20,9,15,4,1,11,18,61.1,7,10,4,6,18,38,33,0,"Matches","https://fbref.com/en/comps/9/2023-2024/defense/2023-2024-Premier-League-Stats"
518,"James Tomkins","/en/players/e7ca0439/James-Tomkins","eng ENG","DF","Crystal Palace",34,1989,0.1,0,0,0,0,0,0,0,NA,0,0,0,0,1,1,0,0,"Matches","https://fbref.com/en/comps/9/2023-2024/defense/2023-2024-Premier-League-Stats"
519,"Sandro Tonali","/en/players/0db169ae/Sandro-Tonali","it ITA","MF","Newcastle Utd",23,2000,4.9,7,7,4,2,1,3,9,33.3,6,3,0,3,2,9,4,0,"Matches","https://fbref.com/en/comps/9/2023-2024/defense/2023-2024-Premier-League-Stats"
520,"Ivan Toney","/en/players/e09f279b/Ivan-Toney","eng ENG","FW","Brentford",27,1996,16.1,15,5,2,7,6,6,14,42.9,8,5,1,4,10,25,18,0,"Matches","https://fbref.com/en/comps/9/2023-2024/defense/2023-2024-Premier-League-Stats"
521,"Pau Torres","/en/players/532e1e4f/Pau-Torres","es ESP","DF","Aston Villa",26,1997,27.4,29,18,17,11,1,14,30,46.7,16,28,12,16,14,43,75,0,"Matches","https://fbref.com/en/comps/9/2023-2024/defense/2023-2024-Premier-League-Stats"
522,"Andros Townsend","/en/players/b28bbd58/Andros-Townsend","eng ENG","MF,FW","Luton Town",32,1991,13.4,21,13,11,2,8,13,27,48.1,14,12,0,12,5,26,10,0,"Matches","https://fbref.com/en/comps/9/2023-2024/defense/2023-2024-Premier-League-Stats"
523,"James Trafford","/en/players/259fea27/James-Trafford","eng ENG","GK","Burnley",20,2002,28,2,1,2,0,0,2,2,100,0,0,0,0,1,3,18,1,"Matches","https://fbref.com/en/comps/9/2023-2024/defense/2023-2024-Premier-League-Stats"
524,"Adama Traoré","/en/players/9a28eba4/Adama-Traore","es ESP","FW,MF","Fulham",27,1996,4.2,4,3,1,2,1,3,6,50,3,2,0,2,1,5,2,0,"Matches","https://fbref.com/en/comps/9/2023-2024/defense/2023-2024-Premier-League-Stats"
525,"Bénie Traoré","/en/players/77816c91/Benie-Traore","ci CIV","FW,MF","Sheffield Utd",20,2002,4.3,4,2,1,2,1,0,4,0,4,4,1,3,1,5,1,0,"Matches","https://fbref.com/en/comps/9/2023-2024/defense/2023-2024-Premier-League-Stats"
526,"Bertrand Traoré","/en/players/c47541e0/Bertrand-Traore","bf BFA","DF,FW","Aston Villa",27,1995,0.1,1,1,1,0,0,0,0,NA,0,0,0,0,0,1,1,0,"Matches","https://fbref.com/en/comps/9/2023-2024/defense/2023-2024-Premier-League-Stats"
527,"Boubacar Traoré","/en/players/999ceb5f/Boubacar-Traore","ml MLI","MF","Wolves",21,2001,9.1,35,23,16,17,2,9,21,42.9,12,12,2,10,5,40,7,0,"Matches","https://fbref.com/en/comps/9/2023-2024/defense/2023-2024-Premier-League-Stats"
528,"Mark Travers","/en/players/fe558029/Mark-Travers","ie IRL","GK","Bournemouth",24,1999,4,0,0,0,0,0,0,0,NA,0,0,0,0,0,0,2,0,"Matches","https://fbref.com/en/comps/9/2023-2024/defense/2023-2024-Premier-League-Stats"
529,"Mike Trésor","/en/players/b2a81fc6/Mike-Tresor","be BEL","FW,MF","Burnley",24,1999,4.7,10,6,9,1,0,8,18,44.4,10,5,0,5,1,11,1,0,"Matches","https://fbref.com/en/comps/9/2023-2024/defense/2023-2024-Premier-League-Stats"
530,"Kieran Trippier","/en/players/21512407/Kieran-Trippier","eng ENG","DF","Newcastle Utd",32,1990,24.8,57,27,30,16,11,37,77,48.1,40,41,8,33,24,81,57,3,"Matches","https://fbref.com/en/comps/9/2023-2024/defense/2023-2024-Premier-League-Stats"
531,"Leandro Trossard","/en/players/38ceb24a/Leandro-Trossard","be BEL","FW,MF","Arsenal",28,1994,18.3,27,16,8,9,10,9,25,36,16,27,1,26,8,35,6,0,"Matches","https://fbref.com/en/comps/9/2023-2024/defense/2023-2024-Premier-League-Stats"
532,"Auston Trusty","/en/players/cddf767b/Auston-Trusty","us USA","DF","Sheffield Utd",24,1998,28.6,47,30,31,13,3,21,43,48.8,22,41,22,19,35,82,153,3,"Matches","https://fbref.com/en/comps/9/2023-2024/defense/2023-2024-Premier-League-Stats"
533,"Kostas Tsimikas","/en/players/f315ca93/Kostas-Tsimikas","gr GRE","DF","Liverpool",27,1996,7.5,19,13,9,6,4,9,15,60,6,9,1,8,6,25,10,0,"Matches","https://fbref.com/en/comps/9/2023-2024/defense/2023-2024-Premier-League-Stats"
534,"Matt Turner","/en/players/4a51ba65/Matt-Turner","us USA","GK","Nott'ham Forest",29,1994,17,0,0,0,0,0,0,0,NA,0,0,0,0,0,0,8,4,"Matches","https://fbref.com/en/comps/9/2023-2024/defense/2023-2024-Premier-League-Stats"
535,"Destiny Udogie","/en/players/7cd520e8/Destiny-Udogie","it ITA","DF","Tottenham",20,2002,26.6,68,33,41,16,11,27,49,55.1,22,27,8,19,37,105,80,5,"Matches","https://fbref.com/en/comps/9/2023-2024/defense/2023-2024-Premier-League-Stats"
536,"Lesley Ugochukwu","/en/players/1df4a109/Lesley-Ugochukwu","fr FRA","MF","Chelsea",19,2004,3.3,14,10,4,8,2,4,10,40,6,6,2,4,1,15,5,0,"Matches","https://fbref.com/en/comps/9/2023-2024/defense/2023-2024-Premier-League-Stats"
537,"Enes Ünal","/en/players/f8eca1b6/Enes-Unal","tr TUR","FW,MF","Bournemouth",26,1997,3.6,6,4,2,3,1,2,5,40,3,4,2,2,1,7,6,0,"Matches","https://fbref.com/en/comps/9/2023-2024/defense/2023-2024-Premier-League-Stats"
538,"Virgil van Dijk","/en/players/e06683ca/Virgil-van-Dijk","nl NED","DF","Liverpool",32,1991,35.3,40,23,24,13,3,12,14,85.7,2,47,34,13,39,79,144,0,"Matches","https://fbref.com/en/comps/9/2023-2024/defense/2023-2024-Premier-League-Stats"
539,"Raphaël Varane","/en/players/9f8e9423/Raphael-Varane","fr FRA","DF","Manchester Utd",30,1993,15.3,18,11,10,7,1,10,14,71.4,4,23,18,5,15,33,88,0,"Matches","https://fbref.com/en/comps/9/2023-2024/defense/2023-2024-Premier-League-Stats"
540,"Alejo Véliz","/en/players/3f7bafbe/Alejo-Veliz","ar ARG","FW","Tottenham",19,2003,0.6,1,0,1,0,0,0,0,NA,0,0,0,0,0,1,0,0,"Matches","https://fbref.com/en/comps/9/2023-2024/defense/2023-2024-Premier-League-Stats"
541,"Joël Veltman","/en/players/dad4b285/Joel-Veltman","nl NED","DF","Brighton",31,1992,17.6,54,41,32,17,5,39,58,67.2,19,17,7,10,18,72,57,1,"Matches","https://fbref.com/en/comps/9/2023-2024/defense/2023-2024-Premier-League-Stats"
542,"Micky van de Ven","/en/players/8fe2a392/Micky-van-de-Ven","nl NED","DF","Tottenham",22,2001,26,49,35,34,12,3,24,33,72.7,9,25,15,10,18,67,78,1,"Matches","https://fbref.com/en/comps/9/2023-2024/defense/2023-2024-Premier-League-Stats"
543,"Bart Verbruggen","/en/players/cf134113/Bart-Verbruggen","nl NED","GK","Brighton",20,2002,21,1,1,1,0,0,1,2,50,1,0,0,0,0,1,11,3,"Matches","https://fbref.com/en/comps/9/2023-2024/defense/2023-2024-Premier-League-Stats"
544,"Guglielmo Vicario","/en/players/77d6fd4d/Guglielmo-Vicario","it ITA","GK","Tottenham",26,1996,38,0,0,0,0,0,0,1,0,1,0,0,0,1,1,31,2,"Matches","https://fbref.com/en/comps/9/2023-2024/defense/2023-2024-Premier-League-Stats"
545,"Fabio Vieira","/en/players/6412cc03/Fabio-Vieira","pt POR","MF,FW","Arsenal",23,2000,3.3,3,2,2,0,1,3,3,100,0,0,0,0,2,5,2,0,"Matches","https://fbref.com/en/comps/9/2023-2024/defense/2023-2024-Premier-League-Stats"
546,"Carlos Vinícius","/en/players/8b529245/Carlos-Vinicius","br BRA","FW","Fulham",28,1995,3.5,3,2,0,1,2,0,4,0,4,4,0,4,0,3,1,0,"Matches","https://fbref.com/en/comps/9/2023-2024/defense/2023-2024-Premier-League-Stats"
547,"Vitinho","/en/players/9295dc1c/Vitinho","br BRA","DF,MF","Burnley",24,1999,25.7,64,34,36,22,6,43,86,50,43,44,6,38,12,76,47,4,"Matches","https://fbref.com/en/comps/9/2023-2024/defense/2023-2024-Premier-League-Stats"
548,"Odisseas Vlachodimos","/en/players/03df04ff/Odisseas-Vlachodimos","gr GRE","GK","Nott'ham Forest",29,1994,5,0,0,0,0,0,0,1,0,1,0,0,0,0,0,1,0,"Matches","https://fbref.com/en/comps/9/2023-2024/defense/2023-2024-Premier-League-Stats"
549,"Kyle Walker","/en/players/86dd77d1/Kyle-Walker","eng ENG","DF","Manchester City",33,1990,30.7,38,24,19,17,2,19,39,48.7,20,19,6,13,27,65,40,1,"Matches","https://fbref.com/en/comps/9/2023-2024/defense/2023-2024-Premier-League-Stats"
550,"Aaron Wan-Bissaka","/en/players/9e525177/Aaron-Wan-Bissaka","eng ENG","DF","Manchester Utd",25,1997,19.8,42,25,18,20,4,19,26,73.1,7,29,15,14,41,83,68,1,"Matches","https://fbref.com/en/comps/9/2023-2024/defense/2023-2024-Premier-League-Stats"
551,"Joel Ward","/en/players/8a7ff278/Joel-Ward","eng ENG","DF","Crystal Palace",33,1989,22,45,28,26,18,1,30,47,63.8,17,17,10,7,14,59,94,1,"Matches","https://fbref.com/en/comps/9/2023-2024/defense/2023-2024-Premier-League-Stats"
552,"James Ward-Prowse","/en/players/3515d404/James-Ward-Prowse","eng ENG","MF","West Ham",28,1994,33.3,45,29,14,23,8,18,44,40.9,26,31,9,22,38,83,49,0,"Matches","https://fbref.com/en/comps/9/2023-2024/defense/2023-2024-Premier-League-Stats"
553,"Lewis Warrington","/en/players/8e633970/Lewis-Warrington","eng ENG","FW","Everton",20,2002,0,0,0,0,0,0,0,0,NA,0,0,0,0,0,0,0,0,"Matches","https://fbref.com/en/comps/9/2023-2024/defense/2023-2024-Premier-League-Stats"
554,"Deivid Washington","/en/players/95bd120d/Deivid-Washington","br BRA","DF,FW","Chelsea",18,2005,0.1,1,1,1,0,0,0,1,0,1,0,0,0,0,1,0,0,"Matches","https://fbref.com/en/comps/9/2023-2024/defense/2023-2024-Premier-League-Stats"
555,"Ollie Watkins","/en/players/aed3a70f/Ollie-Watkins","eng ENG","FW","Aston Villa",27,1995,35.7,12,7,0,5,7,5,11,45.5,6,26,4,22,4,16,20,0,"Matches","https://fbref.com/en/comps/9/2023-2024/defense/2023-2024-Premier-League-Stats"
556,"Adam Webster","/en/players/c40b6180/Adam-Webster","eng ENG","DF","Brighton",28,1995,12.7,14,12,8,5,1,6,18,33.3,12,16,12,4,16,30,43,1,"Matches","https://fbref.com/en/comps/9/2023-2024/defense/2023-2024-Premier-League-Stats"
557,"Danny Welbeck","/en/players/ce5143da/Danny-Welbeck","eng ENG","FW,MF","Brighton",32,1990,18.8,35,17,9,17,9,10,17,58.8,7,12,0,12,9,44,17,1,"Matches","https://fbref.com/en/comps/9/2023-2024/defense/2023-2024-Premier-League-Stats"
558,"Timo Werner","/en/players/49fe9070/Timo-Werner","de GER","FW","Tottenham",27,1996,9,7,4,3,4,0,5,18,27.8,13,12,0,12,3,10,2,0,"Matches","https://fbref.com/en/comps/9/2023-2024/defense/2023-2024-Premier-League-Stats"
559,"Adam Wharton","/en/players/4b542852/Adam-Wharton","eng ENG","MF","Crystal Palace",19,2004,14.4,48,32,18,22,8,23,46,50,23,17,3,14,20,68,24,1,"Matches","https://fbref.com/en/comps/9/2023-2024/defense/2023-2024-Premier-League-Stats"
560,"Ethan Wheatley","/en/players/5c368c88/Ethan-Wheatley","eng ENG","FW","Manchester Utd",17,2006,0.2,1,1,0,1,0,1,1,100,0,2,0,2,2,3,0,0,"Matches","https://fbref.com/en/comps/9/2023-2024/defense/2023-2024-Premier-League-Stats"
561,"Ben White","/en/players/35e413f1/Ben-White","eng ENG","DF","Arsenal",25,1997,33.2,48,28,20,22,6,26,58,44.8,32,48,22,26,32,80,77,1,"Matches","https://fbref.com/en/comps/9/2023-2024/defense/2023-2024-Premier-League-Stats"
562,"Joe White","/en/players/d60c03a9/Joe-White","eng ENG","MF","Newcastle Utd",20,2002,0.1,1,1,1,0,0,0,0,NA,0,0,0,0,0,1,0,0,"Matches","https://fbref.com/en/comps/9/2023-2024/defense/2023-2024-Premier-League-Stats"
563,"Neco Williams","/en/players/dd323728/Neco-Williams","wls WAL","DF","Nott'ham Forest",22,2001,18.2,69,40,42,18,9,35,56,62.5,21,44,13,31,22,91,53,0,"Matches","https://fbref.com/en/comps/9/2023-2024/defense/2023-2024-Premier-League-Stats"
564,"Willian","/en/players/8b9ebd03/Willian","br BRA","FW","Fulham",34,1988,22.8,18,11,6,7,5,3,21,14.3,18,13,0,13,9,27,12,1,"Matches","https://fbref.com/en/comps/9/2023-2024/defense/2023-2024-Premier-League-Stats"
565,"Joe Willock","/en/players/a3b03921/Joe-Willock","eng ENG","MF","Newcastle Utd",23,1999,4.7,13,7,7,6,0,4,11,36.4,7,7,0,7,1,14,1,0,"Matches","https://fbref.com/en/comps/9/2023-2024/defense/2023-2024-Premier-League-Stats"
566,"Callum Wilson","/en/players/c596fcb0/Callum-Wilson","eng ENG","FW","Newcastle Utd",31,1992,11,5,3,0,2,3,0,4,0,4,6,0,6,2,7,4,0,"Matches","https://fbref.com/en/comps/9/2023-2024/defense/2023-2024-Premier-League-Stats"
567,"Harry Wilson","/en/players/c6dc9ecd/Harry-Wilson","wls WAL","FW","Fulham",26,1997,18,21,14,9,8,4,11,28,39.3,17,27,3,24,10,31,12,0,"Matches","https://fbref.com/en/comps/9/2023-2024/defense/2023-2024-Premier-League-Stats"
568,"Yoane Wissa","/en/players/2500cef9/Yoane-Wissa","cd COD","FW","Brentford",26,1996,27.7,28,16,13,10,5,5,20,25,15,24,3,21,9,37,15,0,"Matches","https://fbref.com/en/comps/9/2023-2024/defense/2023-2024-Premier-League-Stats"
569,"Chris Wood","/en/players/4e9a0555/Chris-Wood","nz NZL","FW","Nott'ham Forest",31,1991,20.1,7,4,1,4,2,3,9,33.3,6,11,3,8,1,8,26,0,"Matches","https://fbref.com/en/comps/9/2023-2024/defense/2023-2024-Premier-League-Stats"
570,"Cauley Woodrow","/en/players/d3085b49/Cauley-Woodrow","eng ENG","FW,MF","Luton Town",28,1994,4.7,16,10,8,4,4,9,16,56.3,7,7,1,6,1,17,14,0,"Matches","https://fbref.com/en/comps/9/2023-2024/defense/2023-2024-Premier-League-Stats"
571,"Joe Worrall","/en/players/a5212312/Joe-Worrall","eng ENG","DF","Nott'ham Forest",26,1997,4.9,7,5,6,1,0,3,6,50,3,5,4,1,3,10,32,1,"Matches","https://fbref.com/en/comps/9/2023-2024/defense/2023-2024-Premier-League-Stats"
572,"Yehor Yarmoliuk","/en/players/907a5d7c/Yehor-Yarmoliuk","ua UKR","MF","Brentford",19,2004,7.6,17,11,6,8,3,7,17,41.2,10,17,4,13,6,23,5,0,"Matches","https://fbref.com/en/comps/9/2023-2024/defense/2023-2024-Premier-League-Stats"
573,"Ryan Yates","/en/players/c1fe2a48/Ryan-Yates","eng ENG","MF","Nott'ham Forest",25,1997,22.1,66,40,39,21,6,20,36,55.6,16,42,15,27,21,87,44,1,"Matches","https://fbref.com/en/comps/9/2023-2024/defense/2023-2024-Premier-League-Stats"
574,"Ashley Young","/en/players/be927d03/Ashley-Young","eng ENG","DF,MF","Everton",38,1985,25.3,53,38,28,19,6,30,54,55.6,24,24,6,18,22,75,50,3,"Matches","https://fbref.com/en/comps/9/2023-2024/defense/2023-2024-Premier-League-Stats"
575,"Illia Zabarnyi","/en/players/88968486/Illia-Zabarnyi","ua UKR","DF","Bournemouth",20,2002,37,59,32,29,29,1,23,50,46,27,53,34,19,33,92,143,4,"Matches","https://fbref.com/en/comps/9/2023-2024/defense/2023-2024-Premier-League-Stats"
576,"Nicolò Zaniolo","/en/players/9907b1c8/Nicolo-Zaniolo","it ITA","FW,MF","Aston Villa",24,1999,9.3,19,9,10,7,2,9,17,52.9,8,13,0,13,1,20,11,0,"Matches","https://fbref.com/en/comps/9/2023-2024/defense/2023-2024-Premier-League-Stats"
577,"Anass Zaroury","/en/players/07d65234/Anass-Zaroury","ma MAR","FW,MF","Burnley",22,2000,1.7,1,0,1,0,0,0,4,0,4,2,0,2,0,1,1,1,"Matches","https://fbref.com/en/comps/9/2023-2024/defense/2023-2024-Premier-League-Stats"
578,"Oleksandr Zinchenko","/en/players/51cf8561/Oleksandr-Zinchenko","ua UKR","DF","Arsenal",26,1996,19.1,50,30,19,24,7,35,52,67.3,17,18,3,15,20,70,26,2,"Matches","https://fbref.com/en/comps/9/2023-2024/defense/2023-2024-Premier-League-Stats"
579,"Kurt Zouma","/en/players/ce4246f5/Kurt-Zouma","fr FRA","DF","West Ham",28,1994,31.5,23,17,14,9,0,10,16,62.5,6,38,28,10,29,52,160,0,"Matches","https://fbref.com/en/comps/9/2023-2024/defense/2023-2024-Premier-League-Stats"
580,"Martin Ødegaard","/en/players/79300479/Martin-Odegaard","no NOR","MF","Arsenal",24,1998,34.3,49,17,18,21,10,17,58,29.3,41,23,1,22,15,64,5,0,"Matches","https://fbref.com/en/comps/9/2023-2024/defense/2023-2024-Premier-League-Stats"
