"Season_End_Year","Squad","Comp","Player","Nation","Pos","Age","Born","Mins_Per_90","Tkl_Tackles","TklW_Tackles","Def 3rd_Tackles","Mid 3rd_Tackles","Att 3rd_Tackles","Tkl_Challenges","Att_Challenges","Tkl_percent_Challenges","Lost_Challenges","Blocks_Blocks","Sh_Blocks","Pass_Blocks","Int","Tkl+Int","Clr","Err","Url"
2025,"Alavés","La Liga","Abdel Abqar","MAR","DF","26-078",1999,27.4,36,23,24,11,1,20,34,58.8,14,28,18,10,39,75,146,1,"https://fbref.com/en/players/2bc7f211/Abdel-Abqar"
2025,"Alavés","La Liga","Carles Aleñá","ESP","MF,FW","27-142",1998,12.1,19,12,6,7,6,7,17,41.2,10,11,0,11,2,21,4,0,"https://fbref.com/en/players/6c811eb7/Carles-Alena"
2025,"Alavés","La Liga","Carlos Benavídez","URU","MF","27-058",1998,5.4,19,14,10,6,3,6,11,54.5,5,5,2,3,8,27,14,1,"https://fbref.com/en/players/9fb45456/Carlos-Benavidez"
2025,"Alavés","La Liga","Antonio Blanco","ESP","MF","24-308",2000,30.3,67,40,23,37,7,32,83,38.6,51,30,7,23,42,109,48,1,"https://fbref.com/en/players/506daeac/Antonio-Blanco"
2025,"Alavés","La Liga","Pau Cabanes","ESP","MF,FW","20-099",2005,2.1,8,2,4,3,1,6,13,46.2,7,2,0,2,0,8,1,0,"https://fbref.com/en/players/53440b64/Pau-Cabanes"
2025,"Alavés","La Liga","Tomás Conechny","ARG","FW,MF","27-058",1998,9.4,15,12,6,7,2,9,27,33.3,18,14,2,12,6,21,10,0,"https://fbref.com/en/players/f61143dd/Tomas-Conechny"
2025,"Alavés","La Liga","Moussa Diarra","MLI","DF","24-198",2000,20.7,40,24,19,18,3,17,29,58.6,12,15,5,10,21,61,46,1,"https://fbref.com/en/players/698f11e3/Moussa-Diarra"
2025,"Alavés","La Liga","Facundo Garcés","ARG","DF","25-264",1999,7.5,6,2,4,2,0,3,5,60,2,8,6,2,5,11,51,0,"https://fbref.com/en/players/20c88f8f/Facundo-Garces"
2025,"Alavés","La Liga","Ander Guevara","ESP","MF","27-324",1997,21.6,49,30,19,29,1,20,48,41.7,28,21,5,16,14,63,43,1,"https://fbref.com/en/players/8e48dc61/Ander-Guevara"
2025,"Alavés","La Liga","Jon Guridi","ESP","MF,FW","30-088",1995,23.1,40,22,7,26,7,18,44,40.9,26,19,1,18,14,54,16,0,"https://fbref.com/en/players/4c0a6a48/Jon-Guridi"
2025,"Alavés","La Liga","Joan Jordán","ESP","MF","30-325",1994,15.7,32,18,11,17,4,17,30,56.7,13,12,0,12,9,41,21,0,"https://fbref.com/en/players/2a0c8ba4/Joan-Jordan"
2025,"Alavés","La Liga","Kiké","ESP","FW","35-183",1989,28.2,19,14,1,12,6,6,17,35.3,11,11,4,7,1,20,23,0,"https://fbref.com/en/players/e897d8ba/Kike"
2025,"Alavés","La Liga","Carlos Martín","ESP","FW,MF","23-035",2002,14.8,43,21,18,16,9,13,49,26.5,36,30,1,29,5,48,20,0,"https://fbref.com/en/players/64035864/Carlos-Martin"
2025,"Alavés","La Liga","Toni Martínez","ESP","FW","27-331",1997,11.2,12,7,5,4,3,4,8,50,4,8,2,6,1,13,15,0,"https://fbref.com/en/players/f3945e07/Toni-Martinez"
2025,"Alavés","La Liga","Santiago Mouriño","URU","DF","23-103",2002,20.5,43,28,31,12,0,21,38,55.3,17,27,12,15,29,72,120,0,"https://fbref.com/en/players/91ee5785/Santiago-Mourino"
2025,"Alavés","La Liga","Hugo Novoa","ESP","DF,MF","22-146",2003,2.6,8,5,4,3,1,5,5,100,0,2,1,1,0,8,6,0,"https://fbref.com/en/players/5458f670/Hugo-Novoa"
2025,"Alavés","La Liga","Jesús Owono","EQG","GK","24-087",2001,5.4,1,1,1,0,0,1,1,100,0,0,0,0,0,1,2,0,"https://fbref.com/en/players/d6e3d7fb/Jesus-Owono"
2025,"Alavés","La Liga","Pica","ESP","DF","23-146",2002,5.5,9,7,7,2,0,4,9,44.4,5,7,6,1,9,18,26,0,"https://fbref.com/en/players/9b30eda5/Pica"
2025,"Alavés","La Liga","Abderrahman Rebbach","ALG","FW,MF","26-289",1998,4.3,3,2,3,0,0,0,6,0,6,4,0,4,0,3,6,0,"https://fbref.com/en/players/9a796115/Abderrahman-Rebbach"
2025,"Alavés","La Liga","Luis Rioja","ESP","FW","31-223",1993,0.3,2,1,0,1,1,1,2,50,1,2,0,2,0,2,0,0,"https://fbref.com/en/players/eb3dd471/Luis-Rioja"
2025,"Alavés","La Liga","Adrian Rodriguez","ESP","GK","24-166",2000,1.4,0,0,0,0,0,0,1,0,1,0,0,0,0,0,3,1,"https://fbref.com/en/players/bf17fb4a/Adrian-Rodriguez"
2025,"Alavés","La Liga","Luka Romero","ARG","FW,MF","20-190",2004,2.2,4,4,1,1,2,2,3,66.7,1,2,0,2,1,5,0,0,"https://fbref.com/en/players/ca6edaa0/Luka-Romero"
2025,"Alavés","La Liga","Manu Sánchez","ESP","DF","24-276",2000,29.3,83,56,40,33,10,41,69,59.4,28,51,12,39,30,113,76,1,"https://fbref.com/en/players/ffacd3d5/Manu-Sanchez"
2025,"Alavés","La Liga","Aleksandar Sedlar","SRB","DF","33-165",1991,6.6,18,10,7,11,0,8,10,80,2,2,1,1,10,28,24,1,"https://fbref.com/en/players/a35134ae/Aleksandar-Sedlar"
2025,"Alavés","La Liga","Antonio Sivera","ESP","GK","28-289",1996,31.2,2,1,2,0,0,2,2,100,0,1,0,1,0,2,20,0,"https://fbref.com/en/players/9970da54/Antonio-Sivera"
2025,"Alavés","La Liga","Stoichkov","ESP","MF,FW","31-203",1993,7.8,14,9,6,7,1,6,11,54.5,5,2,0,2,1,15,7,0,"https://fbref.com/en/players/4e257184/Stoichkov"
2025,"Alavés","La Liga","Nahuel Tenaglia","ARG","DF","29-095",1996,32.5,96,61,61,30,5,53,88,60.2,35,33,9,24,47,143,123,2,"https://fbref.com/en/players/66654daa/Nahuel-Tenaglia"
2025,"Alavés","La Liga","Carlos Vicente","ESP","FW,MF","26-034",1999,34.4,47,31,26,11,10,25,64,39.1,39,34,2,32,14,61,40,0,"https://fbref.com/en/players/90df343e/Carlos-Vicente"
2025,"Alavés","La Liga","Asier Villalibre","ESP","FW","27-239",1997,3.7,2,2,0,1,1,1,2,50,1,1,0,1,1,3,7,0,"https://fbref.com/en/players/57be54ec/Asier-Villalibre"
2025,"Angers","Ligue 1","Himad Abdelli","ALG","MF,FW","25-191",1999,31.6,48,32,13,20,15,15,48,31.3,33,24,1,23,26,74,28,2,"https://fbref.com/en/players/7978cbf0/Himad-Abdelli"
2025,"Angers","Ligue 1","Jean-Eudes Aholou","CIV","MF","31-068",1994,21.8,56,36,26,20,10,22,48,45.8,26,34,14,20,33,89,32,0,"https://fbref.com/en/players/48b28bfd/Jean-Eudes-Aholou"
2025,"Angers","Ligue 1","Jim Allevinah","GAB","FW","30-089",1995,19.4,19,11,6,9,4,5,28,17.9,23,10,0,10,12,31,17,0,"https://fbref.com/en/players/1956b948/Jim-Allevinah"
2025,"Angers","Ligue 1","Carlens Arcus","HAI","DF","28-333",1996,22.7,52,35,32,15,5,34,56,60.7,22,24,4,20,27,79,83,3,"https://fbref.com/en/players/5e837126/Carlens-Arcus"
2025,"Angers","Ligue 1","Abdoulaye Bamba","CIV","DF","35-032",1990,16.8,22,12,17,4,1,14,19,73.7,5,14,8,6,19,41,79,0,"https://fbref.com/en/players/7fecbcdb/Abdoulaye-Bamba"
2025,"Angers","Ligue 1","Haris Belkebla","ALG","MF","31-119",1994,19.9,56,38,38,15,3,26,45,57.8,19,30,9,21,35,91,46,1,"https://fbref.com/en/players/2b1bed19/Haris-Belkebla"
2025,"Angers","Ligue 1","Yassin Belkhdim","FRA","MF","23-102",2002,16.9,53,27,26,21,6,27,58,46.6,31,23,6,17,21,74,41,1,"https://fbref.com/en/players/e21d1928/Yassin-Belkhdim"
2025,"Angers","Ligue 1","Emmanuel Biumla","FRA","DF","20-019",2005,14.8,19,12,14,5,0,12,18,66.7,6,18,8,10,8,27,84,1,"https://fbref.com/en/players/e5a94f46/Emmanuel-Biumla"
2025,"Angers","Ligue 1","Ousmane Camara","FRA","DF","22-082",2003,2.8,4,3,3,1,0,1,2,50,1,1,1,0,0,4,18,0,"https://fbref.com/en/players/7d3dfdfd/Ousmane-Camara"
2025,"Angers","Ligue 1","Pierrick Capelle","FRA","MF","38-042",1987,5.4,24,17,10,9,5,9,18,50,9,4,1,3,11,35,5,1,"https://fbref.com/en/players/79b2399c/Pierrick-Capelle"
2025,"Angers","Ligue 1","Enzo Caumont","FRA","MF","21-075",2004,0.4,1,1,0,1,0,1,2,50,1,1,1,0,1,2,1,0,"https://fbref.com/en/players/40581e00/Enzo-Caumont"
2025,"Angers","Ligue 1","Sidiki Cherif","FRA","FW","18-163",2006,3.6,5,5,1,3,1,3,4,75,1,4,1,3,0,5,0,1,"https://fbref.com/en/players/78430598/Sidiki-Cherif"
2025,"Angers","Ligue 1","Marius Courcoul","FRA","MF,DF","18-146",2007,3.4,5,2,3,2,0,2,5,40,3,4,0,4,5,10,9,0,"https://fbref.com/en/players/28ab7aba/Marius-Courcoul"
2025,"Angers","Ligue 1","Bamba Dieng","SEN","FW","25-065",2000,5.9,4,1,1,2,1,0,2,0,2,2,0,2,0,4,3,0,"https://fbref.com/en/players/40774c6b/Bamba-Dieng"
2025,"Angers","Ligue 1","Lois Diony","FRA","FW","32-158",1992,0.2,0,0,0,0,0,0,0,NA,0,0,0,0,0,0,0,0,"https://fbref.com/en/players/4be0b467/Lois-Diony"
2025,"Angers","Ligue 1","Jacques Ekomie","GAB","DF,FW","21-281",2003,7.7,22,14,9,10,3,8,12,66.7,4,16,5,11,4,26,14,0,"https://fbref.com/en/players/8d5016e6/Jacques-Ekomie"
2025,"Angers","Ligue 1","Zinedine Ferhat","ALG","FW,MF","32-087",1993,9.4,9,7,1,5,3,4,13,30.8,9,9,0,9,10,19,12,0,"https://fbref.com/en/players/005c0807/Zinedine-Ferhat"
2025,"Angers","Ligue 1","Yahia Fofana","CIV","GK","24-279",2000,33,0,0,0,0,0,0,2,0,2,0,0,0,1,1,25,2,"https://fbref.com/en/players/9d420dad/Yahia-Fofana"
2025,"Angers","Ligue 1","Florent Hanin","ALG","DF","35-112",1990,29.7,69,48,45,17,7,39,71,54.9,32,31,10,21,47,116,99,2,"https://fbref.com/en/players/6bfb4303/Florent-Hanin"
2025,"Angers","Ligue 1","Cédric Hountondji","BEN","DF","31-128",1994,3,6,4,4,2,0,3,7,42.9,4,3,3,0,4,10,14,0,"https://fbref.com/en/players/00891164/Cedric-Hountondji"
2025,"Angers","Ligue 1","Justin-Noël Kalumba","FRA","FW,MF","20-153",2004,0.3,0,0,0,0,0,0,0,NA,0,0,0,0,1,1,1,0,"https://fbref.com/en/players/32e2163d/Justin-Noel-Kalumba"
2025,"Angers","Ligue 1","Jordan Lefort","FRA","DF","31-291",1993,34,52,30,42,9,1,30,44,68.2,14,56,37,19,32,84,206,3,"https://fbref.com/en/players/c3e4ecbb/Jordan-Lefort"
2025,"Angers","Ligue 1","Esteban Lepaul","FRA","FW","25-039",2000,18.1,11,6,2,6,3,4,16,25,12,15,2,13,4,15,10,0,"https://fbref.com/en/players/85ce1949/Esteban-Lepaul"
2025,"Angers","Ligue 1","Lanroy Machine","FRA","FW","19-226",2005,0.1,0,0,0,0,0,0,0,NA,0,0,0,0,0,0,0,0,"https://fbref.com/en/players/e7cf1d4c/Lanroy-Machine"
2025,"Angers","Ligue 1","Farid El Melali","ALG","FW","28-022",1997,21,28,16,15,6,7,13,35,37.1,22,19,1,18,16,44,12,1,"https://fbref.com/en/players/d21e361a/Farid-El-Melali"
2025,"Angers","Ligue 1","Ibrahima Niane","SEN","FW","26-077",1999,10.5,7,3,3,2,2,3,3,100,0,6,1,5,2,9,6,2,"https://fbref.com/en/players/46faabfa/Ibrahima-Niane"
2025,"Angers","Ligue 1","Zinédine Ould Khaled","FRA","MF","25-133",2000,3.8,9,7,5,3,1,2,13,15.4,11,6,1,5,2,11,12,0,"https://fbref.com/en/players/6b4436ba/Zinedine-Ould-Khaled"
2025,"Angers","Ligue 1","Prosper Peter","NGA","MF,FW","17-291",2007,0.3,2,1,0,2,0,0,0,NA,0,0,0,0,0,2,0,0,"https://fbref.com/en/players/1bfb331d/Prosper-Peter"
2025,"Angers","Ligue 1","Lilian Raolisoa","FRA","DF,FW","24-345",2000,14.6,41,24,24,13,4,17,38,44.7,21,11,2,9,15,56,45,0,"https://fbref.com/en/players/79a793b7/Lilian-Raolisoa"
2025,"Angers","Ligue 1","Melvin Zinga","FRA","GK","23-072",2002,1,0,0,0,0,0,0,0,NA,0,0,0,0,0,0,1,0,"https://fbref.com/en/players/1d59fe9c/Melvin-Zinga"
2025,"Arsenal","Premier League","Nathan Butler-Oyedeji","ENG","FW","22-143",2003,0.1,0,0,0,0,0,0,0,NA,0,0,0,0,0,0,0,0,"https://fbref.com/en/players/3a686640/Nathan-Butler-Oyedeji"
2025,"Arsenal","Premier League","Riccardo Calafiori","ITA","DF","23-008",2002,10.9,27,19,15,10,2,18,29,62.1,11,12,6,6,9,36,25,0,"https://fbref.com/en/players/aded8e6f/Riccardo-Calafiori"
2025,"Arsenal","Premier League","Kai Havertz","GER","FW,MF","25-350",1999,20.8,16,9,3,6,7,4,15,26.7,11,23,4,19,6,22,33,1,"https://fbref.com/en/players/fed7cb61/Kai-Havertz"
2025,"Arsenal","Premier League","Gabriel Jesus","BRA","FW","28-054",1997,6.8,10,6,4,3,3,4,9,44.4,5,10,1,9,4,14,8,0,"https://fbref.com/en/players/b66315ae/Gabriel-Jesus"
2025,"Arsenal","Premier League","Jorginho","ITA","MF","33-158",1991,7.8,12,4,1,7,4,8,20,40,12,3,0,3,7,19,2,2,"https://fbref.com/en/players/45db685d/Jorginho"
2025,"Arsenal","Premier League","Jakub Kiwior","POL","DF","25-101",2000,12.5,22,8,13,7,2,11,15,73.3,4,13,8,5,6,28,58,3,"https://fbref.com/en/players/dc3e663e/Jakub-Kiwior"
2025,"Arsenal","Premier League","Myles Lewis-Skelly","ENG","DF","18-243",2006,15.2,22,14,10,9,3,10,11,90.9,1,4,1,3,7,29,27,0,"https://fbref.com/en/players/5dff6c28/Myles-Lewis-Skelly"
2025,"Arsenal","Premier League","Gabriel Magalhães","BRA","DF","27-159",1997,26.3,25,15,12,8,5,12,16,75,4,42,29,13,16,41,93,2,"https://fbref.com/en/players/67ac5bb8/Gabriel-Magalhaes"
2025,"Arsenal","Premier League","Gabriel Martinelli","BRA","FW,MF","23-343",2001,25.5,23,15,9,6,8,7,23,30.4,16,15,0,15,5,28,19,0,"https://fbref.com/en/players/48a5a5d6/Gabriel-Martinelli"
2025,"Arsenal","Premier League","Mikel Merino","ESP","MF,FW","28-339",1996,17.6,46,28,7,26,13,20,36,55.6,16,18,5,13,15,61,26,2,"https://fbref.com/en/players/d080ed5e/Mikel-Merino"
2025,"Arsenal","Premier League","Reiss Nelson","ENG","FW","25-168",1999,0,1,0,0,1,0,0,1,0,1,0,0,0,0,1,1,0,"https://fbref.com/en/players/c5bdb6e3/Reiss-Nelson"
2025,"Arsenal","Premier League","Ethan Nwaneri","ENG","FW,MF","18-067",2007,9.9,11,7,4,4,3,7,21,33.3,14,8,2,6,2,13,4,1,"https://fbref.com/en/players/7f94982c/Ethan-Nwaneri"
2025,"Arsenal","Premier League","Thomas Partey","GHA","MF,DF","31-348",1993,31.1,89,53,26,39,24,46,76,60.5,30,29,9,20,35,124,49,4,"https://fbref.com/en/players/529f49ab/Thomas-Partey"
2025,"Arsenal","Premier League","David Raya","ESP","GK","29-254",1995,38,0,0,0,0,0,0,2,0,2,0,0,0,2,2,21,9,"https://fbref.com/en/players/98ea5115/David-Raya"
2025,"Arsenal","Premier League","Declan Rice","ENG","MF","26-133",1999,31.4,53,25,22,25,6,17,41,41.5,24,27,13,14,25,78,51,0,"https://fbref.com/en/players/1c7012b8/Declan-Rice"
2025,"Arsenal","Premier League","Bukayo Saka","ENG","FW,MF","23-264",2001,19.2,29,15,9,11,9,13,24,54.2,11,22,0,22,3,32,8,0,"https://fbref.com/en/players/bc7dc64d/Bukayo-Saka"
2025,"Arsenal","Premier League","William Saliba","FRA","DF","24-064",2001,33.8,62,37,37,23,2,21,28,75,7,25,15,10,21,83,119,7,"https://fbref.com/en/players/972aeb2a/William-Saliba"
2025,"Arsenal","Premier League","Raheem Sterling","ENG","FW,MF","30-170",1994,5.5,9,4,1,3,5,5,10,50,5,3,0,3,1,10,4,0,"https://fbref.com/en/players/b400bde0/Raheem-Sterling"
2025,"Arsenal","Premier League","Kieran Tierney","SCO","DF,FW","27-356",1997,2.9,7,5,4,1,2,4,6,66.7,2,0,0,0,3,10,9,0,"https://fbref.com/en/players/fce2302c/Kieran-Tierney"
2025,"Arsenal","Premier League","Jurriën Timber","NED","DF","23-344",2001,26.9,58,38,17,30,11,18,27,66.7,9,19,4,15,22,80,44,1,"https://fbref.com/en/players/41034650/Jurrien-Timber"
2025,"Arsenal","Premier League","Takehiro Tomiyasu","JPN","DF","26-203",1998,0.1,0,0,0,0,0,0,0,NA,0,0,0,0,0,0,1,0,"https://fbref.com/en/players/b3af9be1/Takehiro-Tomiyasu"
2025,"Arsenal","Premier League","Leandro Trossard","BEL","FW","30-174",1994,28.3,31,20,6,16,9,12,34,35.3,22,32,0,32,9,40,18,0,"https://fbref.com/en/players/38ceb24a/Leandro-Trossard"
2025,"Arsenal","Premier League","Ben White","ENG","DF","27-231",1997,13.3,20,14,10,4,6,16,38,42.1,22,10,8,2,16,36,44,0,"https://fbref.com/en/players/35e413f1/Ben-White"
2025,"Arsenal","Premier League","Oleksandr Zinchenko","UKR","DF,MF","28-163",1996,5.9,6,1,1,3,2,3,8,37.5,5,8,1,7,5,11,10,0,"https://fbref.com/en/players/51cf8561/Oleksandr-Zinchenko"
2025,"Arsenal","Premier League","Martin Ødegaard","NOR","MF","26-161",1998,25.8,19,11,9,7,3,4,25,16,21,5,0,5,6,25,6,1,"https://fbref.com/en/players/79300479/Martin-Odegaard"
2025,"Aston Villa","Premier League","Marco Asensio","ESP","MF","29-126",1996,8.3,7,5,0,7,0,3,9,33.3,6,7,1,6,2,9,3,0,"https://fbref.com/en/players/45af8a54/Marco-Asensio"
2025,"Aston Villa","Premier League","Leon Bailey","JAM","FW,MF","27-291",1997,12.7,7,5,2,3,2,3,11,27.3,8,6,0,6,3,10,12,0,"https://fbref.com/en/players/3a233281/Leon-Bailey"
2025,"Aston Villa","Premier League","Ross Barkley","ENG","MF","31-173",1993,6.5,14,3,4,10,0,9,14,64.3,5,9,3,6,10,24,5,0,"https://fbref.com/en/players/3a24769f/Ross-Barkley"
2025,"Aston Villa","Premier League","Lamare Bogarde","NED","DF,MF","21-142",2004,5.3,14,6,6,6,2,10,16,62.5,6,5,3,2,1,15,13,0,"https://fbref.com/en/players/bca5c4a7/Lamare-Bogarde"
2025,"Aston Villa","Premier League","Emi Buendía","ARG","MF,FW","28-153",1996,1.1,6,6,3,2,1,0,5,0,5,5,1,4,0,6,2,0,"https://fbref.com/en/players/66b76d44/Emi-Buendia"
2025,"Aston Villa","Premier League","Diego Carlos","BRA","DF","32-073",1993,9.2,8,3,6,1,1,4,6,66.7,2,13,7,6,5,13,36,2,"https://fbref.com/en/players/b4a014b1/Diego-Carlos"
2025,"Aston Villa","Premier League","Matty Cash","POL","DF","27-293",1997,23,56,32,29,21,6,31,43,72.1,12,22,8,14,23,79,70,2,"https://fbref.com/en/players/2389cdc2/Matty-Cash"
2025,"Aston Villa","Premier League","Lucas Digne","FRA","DF","31-311",1993,26.1,65,38,40,16,9,44,66,66.7,22,23,4,19,25,90,89,1,"https://fbref.com/en/players/1b84dbe1/Lucas-Digne"
2025,"Aston Villa","Premier League","Axel Disasi","FRA","DF","27-077",1998,5.4,8,5,7,1,0,3,7,42.9,4,4,1,3,5,13,18,0,"https://fbref.com/en/players/ad82197c/Axel-Disasi"
2025,"Aston Villa","Premier League","Jáder Durán","COL","FW","21-165",2003,7.1,8,7,1,2,5,1,4,25,3,5,0,5,0,8,13,0,"https://fbref.com/en/players/414184f7/Jader-Duran"
2025,"Aston Villa","Premier League","Andrés García","ESP","DF,MF","22-109",2003,3.5,9,5,5,3,1,4,8,50,4,2,0,2,2,11,10,2,"https://fbref.com/en/players/40498af1/Andres-Garcia"
2025,"Aston Villa","Premier League","Boubacar Kamara","FRA","MF","25-185",1999,19.2,50,21,28,18,4,29,56,51.8,27,19,7,12,19,69,51,3,"https://fbref.com/en/players/cc77354e/Boubacar-Kamara"
2025,"Aston Villa","Premier League","Ezri Konsa","ENG","DF","27-216",1997,32.6,34,18,20,10,4,20,25,80,5,20,11,9,24,58,114,4,"https://fbref.com/en/players/0313a347/Ezri-Konsa"
2025,"Aston Villa","Premier League","Ian Maatsen","NED","DF","23-078",2002,12.7,29,17,17,9,3,17,24,70.8,7,13,0,13,15,44,39,3,"https://fbref.com/en/players/cab9634e/Ian-Maatsen"
2025,"Aston Villa","Premier League","Donyell Malen","NED","FW","26-138",1999,3.4,7,4,3,3,1,1,4,25,3,2,0,2,0,7,1,0,"https://fbref.com/en/players/116c35df/Donyell-Malen"
2025,"Aston Villa","Premier League","Emiliano Martínez","ARG","GK","32-267",1992,35.5,3,3,3,0,0,2,2,100,0,1,0,1,0,3,17,6,"https://fbref.com/en/players/7956236f/Emiliano-Martinez"
2025,"Aston Villa","Premier League","John McGinn","SCO","MF,FW","30-221",1994,24.7,33,24,10,14,9,13,31,41.9,18,22,2,20,14,47,18,3,"https://fbref.com/en/players/90f91999/John-McGinn"
2025,"Aston Villa","Premier League","Tyrone Mings","ENG","DF","32-075",1993,12.4,7,6,6,1,0,2,2,100,0,13,11,2,7,14,61,1,"https://fbref.com/en/players/8397a50c/Tyrone-Mings"
2025,"Aston Villa","Premier League","Kosta Nedeljković","SRB","DF","19-162",2005,1.4,7,5,1,3,3,2,3,66.7,1,1,0,1,0,7,3,0,"https://fbref.com/en/players/c70be9cf/Kosta-Nedeljkovic"
2025,"Aston Villa","Premier League","Robin Olsen","SWE","GK","35-139",1990,2.5,1,0,1,0,0,1,1,100,0,0,0,0,0,1,2,1,"https://fbref.com/en/players/e7ee38c3/Robin-Olsen"
2025,"Aston Villa","Premier League","Amadou Onana","BEL","MF","23-284",2001,18,55,30,23,26,6,16,29,55.2,13,16,7,9,26,81,41,3,"https://fbref.com/en/players/828657ff/Amadou-Onana"
2025,"Aston Villa","Premier League","Jaden Philogene Bidace","ENG","FW,MF","23-108",2002,3.7,11,5,4,7,0,4,6,66.7,2,5,0,5,3,14,2,1,"https://fbref.com/en/players/19f4d211/Jaden-Philogene-Bidace"
2025,"Aston Villa","Premier League","Jacob Ramsey","ENG","FW,MF","23-364",2001,18,30,15,14,10,6,10,20,50,10,23,4,19,8,38,8,1,"https://fbref.com/en/players/1544f145/Jacob-Ramsey"
2025,"Aston Villa","Premier League","Marcus Rashford","ENG","FW","27-208",1997,4.9,10,7,2,3,5,4,6,66.7,2,2,0,2,1,11,3,0,"https://fbref.com/en/players/a1d5bd30/Marcus-Rashford"
2025,"Aston Villa","Premier League","Morgan Rogers","ENG","FW,MF","22-305",2002,34.6,43,22,15,15,13,24,47,51.1,23,26,7,19,6,49,20,2,"https://fbref.com/en/players/2e5915f1/Morgan-Rogers"
2025,"Aston Villa","Premier League","Youri Tielemans","BEL","MF","28-020",1997,33.6,84,58,32,44,8,40,73,54.8,33,38,16,22,23,107,47,4,"https://fbref.com/en/players/56f7a928/Youri-Tielemans"
2025,"Aston Villa","Premier League","Pau Torres","ESP","DF","28-131",1997,22.4,21,15,11,8,2,10,17,58.8,7,16,11,5,10,31,75,2,"https://fbref.com/en/players/532e1e4f/Pau-Torres"
2025,"Aston Villa","Premier League","Ollie Watkins","ENG","FW","29-148",1995,28.9,10,7,0,6,4,3,11,27.3,8,11,3,8,8,18,15,2,"https://fbref.com/en/players/aed3a70f/Ollie-Watkins"
2025,"Atalanta","Serie A","Mitchel Bakker","NED","MF","24-341",2000,0.2,1,0,1,0,0,1,1,100,0,0,0,0,0,1,0,0,"https://fbref.com/en/players/a8567629/Mitchel-Bakker"
2025,"Atalanta","Serie A","Raoul Bellanova","ITA","DF","25-010",2000,26.7,24,14,8,13,3,13,21,61.9,8,12,3,9,18,42,45,0,"https://fbref.com/en/players/e3756e72/Raoul-Bellanova"
2025,"Atalanta","Serie A","Marco Brescianini","ITA","MF","25-127",2000,11,18,11,5,9,4,8,10,80,2,15,2,13,2,20,6,0,"https://fbref.com/en/players/dfd56738/Marco-Brescianini"
2025,"Atalanta","Serie A","Marco Carnesecchi","ITA","GK","24-330",2000,34,0,0,0,0,0,0,0,NA,0,1,0,1,0,0,26,2,"https://fbref.com/en/players/8ec56e62/Marco-Carnesecchi"
2025,"Atalanta","Serie A","Federico Cassa","ITA","MF,FW","19-115",2006,0.2,0,0,0,0,0,0,0,NA,0,1,0,1,0,0,0,0,"https://fbref.com/en/players/5f209d47/Federico-Cassa"
2025,"Atalanta","Serie A","Juan Cuadrado","COL","DF,MF","37-001",1988,9.2,19,9,9,6,4,11,23,47.8,12,14,2,12,7,26,9,0,"https://fbref.com/en/players/0ab1f153/Juan-Cuadrado"
2025,"Atalanta","Serie A","Charles De Ketelaere","BEL","MF,FW","24-078",2001,23,13,9,2,9,2,4,15,26.7,11,14,3,11,3,16,9,1,"https://fbref.com/en/players/2ef7c612/Charles-De-Ketelaere"
2025,"Atalanta","Serie A","Berat Djimsiti","ALB","DF","32-097",1993,29.3,53,33,29,23,1,29,40,72.5,11,34,21,13,40,93,141,2,"https://fbref.com/en/players/6eee05f1/Berat-Djimsiti"
2025,"Atalanta","Serie A","Éderson","BRA","MF","25-324",1999,32,52,32,19,28,5,22,34,64.7,12,30,6,24,35,87,36,1,"https://fbref.com/en/players/a9202def/Ederson"
2025,"Atalanta","Serie A","Ben Godfrey","ENG","DF","27-132",1998,0.3,0,0,0,0,0,0,1,0,1,1,1,0,0,0,0,0,"https://fbref.com/en/players/9f7c837d/Ben-Godfrey"
2025,"Atalanta","Serie A","Isak Hien","SWE","DF","26-134",1999,25.9,48,28,27,21,0,27,44,61.4,17,31,18,13,31,79,82,2,"https://fbref.com/en/players/12806697/Isak-Hien"
2025,"Atalanta","Serie A","Sead Kolašinac","BIH","DF","31-341",1993,21.1,41,26,21,20,0,16,30,53.3,14,16,7,9,25,66,53,1,"https://fbref.com/en/players/3935e52e/Sead-Kolasinac"
2025,"Atalanta","Serie A","Odilon Kossounou","CIV","DF","24-143",2001,12.5,16,11,8,6,2,6,13,46.2,7,16,6,10,13,29,25,1,"https://fbref.com/en/players/1f3afdcb/Odilon-Kossounou"
2025,"Atalanta","Serie A","Ademola Lookman","NGA","MF,FW","27-219",1997,25,32,15,9,15,8,11,19,57.9,8,19,0,19,3,35,5,1,"https://fbref.com/en/players/7c104bb7/Ademola-Lookman"
2025,"Atalanta","Serie A","Daniel Maldini","ITA","FW,MF","23-228",2001,2.9,2,2,0,1,1,1,2,50,1,1,0,1,2,4,3,0,"https://fbref.com/en/players/801831fe/Daniel-Maldini"
2025,"Atalanta","Serie A","Alberto Manzoni","ITA","MF","19-336",2005,0.1,0,0,0,0,0,0,0,NA,0,0,0,0,0,0,0,0,"https://fbref.com/en/players/08cda374/Alberto-Manzoni"
2025,"Atalanta","Serie A","Juan Musso","ARG","GK","31-021",1994,1,0,0,0,0,0,0,0,NA,0,0,0,0,0,0,0,0,"https://fbref.com/en/players/a111cf41/Juan-Musso"
2025,"Atalanta","Serie A","Marco Palestra","ITA","DF","20-085",2005,2.5,6,4,3,2,1,3,3,100,0,4,1,3,2,8,4,0,"https://fbref.com/en/players/1f1828dd/Marco-Palestra"
2025,"Atalanta","Serie A","Mario Pašalić","CRO","MF","30-107",1995,21.9,26,16,11,13,2,11,26,42.3,15,22,7,15,12,38,28,1,"https://fbref.com/en/players/e599253a/Mario-Pasalic"
2025,"Atalanta","Serie A","Rui Patrício","POR","GK","37-101",1988,3,0,0,0,0,0,0,0,NA,0,0,0,0,0,0,3,0,"https://fbref.com/en/players/79b0d6a0/Rui-Patricio"
2025,"Atalanta","Serie A","Stefan Posch","AUT","DF","28-013",1997,4.3,18,11,7,8,3,8,9,88.9,1,5,1,4,4,22,13,0,"https://fbref.com/en/players/7f609bfc/Stefan-Posch"
2025,"Atalanta","Serie A","Mateo Retegui","ITA","FW","26-028",1999,26.5,14,9,0,9,5,3,16,18.8,13,7,0,7,4,18,17,0,"https://fbref.com/en/players/e7695e6c/Mateo-Retegui"
2025,"Atalanta","Serie A","Marten de Roon","NED","MF,DF","34-059",1991,34,74,48,32,38,4,30,66,45.5,36,40,7,33,47,121,67,1,"https://fbref.com/en/players/2a1beb34/Marten-de-Roon"
2025,"Atalanta","Serie A","Matteo Ruggeri","ITA","DF","22-320",2002,19.5,39,24,15,14,10,25,39,64.1,14,30,4,26,22,61,50,1,"https://fbref.com/en/players/ae9898c5/Matteo-Ruggeri"
2025,"Atalanta","Serie A","Lazar Samardzic","SRB","MF","23-092",2002,13,21,15,5,7,9,12,25,48,13,9,1,8,2,23,6,0,"https://fbref.com/en/players/217c93a1/Lazar-Samardzic"
2025,"Atalanta","Serie A","Giorgio Scalvini","ITA","DF","21-167",2003,3,8,4,5,3,0,5,9,55.6,4,0,0,0,4,12,7,0,"https://fbref.com/en/players/1e9aa637/Giorgio-Scalvini"
2025,"Atalanta","Serie A","Gianluca Scamacca","ITA","FW","26-146",1999,0.1,0,0,0,0,0,0,0,NA,0,0,0,0,0,0,0,0,"https://fbref.com/en/players/8790f988/Gianluca-Scamacca"
2025,"Atalanta","Serie A","Ibrahim Sulemana","GHA","MF","22-005",2003,3.1,9,4,4,5,0,2,8,25,6,2,0,2,0,9,1,0,"https://fbref.com/en/players/230c3f3a/Ibrahim-Sulemana"
2025,"Atalanta","Serie A","Rafael Tolói","ITA","DF","34-229",1990,5.2,10,5,3,5,2,4,11,36.4,7,8,2,6,8,18,11,0,"https://fbref.com/en/players/c56dc39e/Rafael-Toloi"
2025,"Atalanta","Serie A","Vanja Vlahović","SRB","FW,MF","21-065",2004,0.7,1,1,0,0,1,0,0,NA,0,0,0,0,0,1,0,0,"https://fbref.com/en/players/2af3f55c/Vanja-Vlahovic"
2025,"Atalanta","Serie A","Nicolò Zaniolo","ITA","FW,MF","25-329",1999,4,0,0,0,0,0,0,2,0,2,0,0,0,1,1,0,0,"https://fbref.com/en/players/9907b1c8/Nicolo-Zaniolo"
2025,"Atalanta","Serie A","Davide Zappacosta","ITA","DF","32-350",1992,23,26,16,15,5,6,20,39,51.3,19,28,6,22,11,37,32,2,"https://fbref.com/en/players/7fe90ccd/Davide-Zappacosta"
2025,"Athletic Club","La Liga","Julen Agirrezabala","ESP","GK","24-152",2000,13.4,0,0,0,0,0,0,1,0,1,0,0,0,0,0,4,0,"https://fbref.com/en/players/a2c1a8d3/Julen-Agirrezabala"
2025,"Athletic Club","La Liga","Yeray Álvarez","ESP","DF","30-123",1995,19.8,25,13,14,9,2,15,22,68.2,7,10,6,4,34,59,129,1,"https://fbref.com/en/players/3ecc11d8/Yeray-Alvarez"
2025,"Athletic Club","La Liga","Adu Ares","ESP","FW","23-227",2001,0.2,0,0,0,0,0,0,1,0,1,0,0,0,0,0,0,0,"https://fbref.com/en/players/a461f098/Adu-Ares"
2025,"Athletic Club","La Liga","Yuri Berchiche","ESP","DF","35-106",1990,22.7,33,21,19,11,3,19,33,57.6,14,25,5,20,27,60,72,3,"https://fbref.com/en/players/b6e50615/Yuri-Berchiche"
2025,"Athletic Club","La Liga","Álex Berenguer","ESP","FW,MF","29-327",1995,26,32,16,6,16,10,14,31,45.2,17,23,2,21,10,42,18,0,"https://fbref.com/en/players/dc1c2fce/Alex-Berenguer"
2025,"Athletic Club","La Liga","Adama Boiro","ESP","DF,FW","22-339",2002,12.2,20,11,11,7,2,10,15,66.7,5,10,3,7,12,32,27,1,"https://fbref.com/en/players/e7992f7b/Adama-Boiro"
2025,"Athletic Club","La Liga","Endika Buján","ESP","FW","22-131",2003,0.1,0,0,0,0,0,0,1,0,1,0,0,0,0,0,0,0,"https://fbref.com/en/players/72699f75/Endika-Bujan"
2025,"Athletic Club","La Liga","Peio Canales","ESP","MF,FW","20-130",2005,2.9,3,2,0,1,2,1,1,100,0,3,0,3,2,5,2,0,"https://fbref.com/en/players/3b5d2ab7/Peio-Canales"
2025,"Athletic Club","La Liga","Álvaro djaló","ESP","FW","25-284",1999,7.3,8,5,3,2,3,1,3,33.3,2,4,0,4,1,9,4,0,"https://fbref.com/en/players/45c29ae7/Alvaro-djalo"
2025,"Athletic Club","La Liga","Iñigo Ruiz de Galarreta","ESP","MF","31-294",1993,16.4,36,22,11,17,8,20,31,64.5,11,11,4,7,16,52,14,2,"https://fbref.com/en/players/91f7631f/Inigo-Ruiz-de-Galarreta"
2025,"Athletic Club","La Liga","Unai Gómez","ESP","MF,FW","22-002",2003,14.3,12,8,3,7,2,4,7,57.1,3,13,1,12,2,14,15,1,"https://fbref.com/en/players/37db6cae/Unai-Gomez"
2025,"Athletic Club","La Liga","Andoni Gorosabel","ESP","DF","28-296",1996,16.5,47,28,31,9,7,30,45,66.7,15,18,2,16,18,65,62,0,"https://fbref.com/en/players/6f5f82c0/Andoni-Gorosabel"
2025,"Athletic Club","La Liga","Gorka Guruzeta","ESP","FW","28-257",1996,20.4,16,8,1,13,2,7,31,22.6,24,28,4,24,9,25,23,0,"https://fbref.com/en/players/6b5ea2f4/Gorka-Guruzeta"
2025,"Athletic Club","La Liga","Ander Herrera","ESP","MF","35-286",1989,3,8,4,1,7,0,3,6,50,3,1,0,1,2,10,10,0,"https://fbref.com/en/players/436a9dd0/Ander-Herrera"
2025,"Athletic Club","La Liga","Mikel Jauregizar","ESP","MF","21-196",2003,24.9,84,48,25,45,14,41,83,49.4,42,24,4,20,29,113,36,2,"https://fbref.com/en/players/2f5c78ca/Mikel-Jauregizar"
2025,"Athletic Club","La Liga","Iñigo Lekue","ESP","DF","32-023",1993,8.6,15,12,12,3,0,9,17,52.9,8,7,2,5,9,24,29,2,"https://fbref.com/en/players/59b7d823/Inigo-Lekue"
2025,"Athletic Club","La Liga","Óscar de Marcos","ESP","DF","36-043",1989,17.4,32,15,15,13,4,21,37,56.8,16,17,1,16,16,48,35,0,"https://fbref.com/en/players/9f323c71/Oscar-de-Marcos"
2025,"Athletic Club","La Liga","Javi Martón","ESP","FW,MF","26-021",1999,0.6,0,0,0,0,0,0,0,NA,0,0,0,0,0,0,0,0,"https://fbref.com/en/players/2381eead/Javi-Marton"
2025,"Athletic Club","La Liga","Unai Núñez","ESP","DF","28-117",1997,7.2,10,5,7,3,0,4,7,57.1,3,4,4,0,17,27,46,1,"https://fbref.com/en/players/be170419/Unai-Nunez"
2025,"Athletic Club","La Liga","Aingeru Olabarrieta","ESP","FW","19-194",2005,0.6,0,0,0,0,0,0,0,NA,0,2,0,2,1,1,1,0,"https://fbref.com/en/players/b7e92b0e/Aingeru-Olabarrieta"
2025,"Athletic Club","La Liga","Alex Padilla","ESP","GK","21-268",2003,3.6,0,0,0,0,0,0,0,NA,0,0,0,0,0,0,2,1,"https://fbref.com/en/players/a275838a/Alex-Padilla"
2025,"Athletic Club","La Liga","Aitor Paredes","ESP","DF","25-028",2000,20.1,15,13,10,5,0,8,15,53.3,7,26,15,11,22,37,114,4,"https://fbref.com/en/players/b906757a/Aitor-Paredes"
2025,"Athletic Club","La Liga","Beñat Prados","ESP","MF","24-108",2001,19.1,55,36,20,27,8,25,53,47.2,28,21,2,19,28,83,26,0,"https://fbref.com/en/players/1f60244a/Benat-Prados"
2025,"Athletic Club","La Liga","Oihan Sancet","ESP","MF","25-032",2000,18,13,8,6,6,1,5,14,35.7,9,10,0,10,5,18,6,0,"https://fbref.com/en/players/bdb624a3/Oihan-Sancet"
2025,"Athletic Club","La Liga","Maroan Sannadi","ESP","FW","24-115",2001,8.4,5,0,1,4,0,2,7,28.6,5,1,0,1,1,6,2,1,"https://fbref.com/en/players/bea2537a/Maroan-Sannadi"
2025,"Athletic Club","La Liga","Nicolás Serrano","ESP","FW","22-083",2003,1.2,1,1,0,1,0,1,3,33.3,2,4,0,4,1,2,1,0,"https://fbref.com/en/players/2ad0e5e5/Nicolas-Serrano"
2025,"Athletic Club","La Liga","Unai Simón","ESP","GK","27-350",1997,21,0,0,0,0,0,0,0,NA,0,1,0,1,1,1,14,4,"https://fbref.com/en/players/5dcf3e90/Unai-Simon"
2025,"Athletic Club","La Liga","Mikel Vesga","ESP","MF","32-006",1993,11,22,15,7,13,2,12,28,42.9,16,10,1,9,15,37,26,0,"https://fbref.com/en/players/b0fce72c/Mikel-Vesga"
2025,"Athletic Club","La Liga","Daniel Vivian","ESP","DF","25-316",1999,29,40,26,23,14,3,21,32,65.6,11,26,10,16,47,87,152,2,"https://fbref.com/en/players/ab7bf91d/Daniel-Vivian"
2025,"Athletic Club","La Liga","Iñaki Williams","GHA","FW","30-346",1994,29.5,17,10,4,8,5,12,23,52.2,11,34,5,29,12,29,32,0,"https://fbref.com/en/players/6a99e0b1/Inaki-Williams"
2025,"Athletic Club","La Liga","Nico Williams","ESP","FW","22-319",2002,22.2,28,18,10,11,7,11,32,34.4,21,20,1,19,7,35,9,0,"https://fbref.com/en/players/afdc14d7/Nico-Williams"
2025,"Atlético Madrid","La Liga","Julián Álvarez","ARG","FW","25-116",2000,27.9,25,17,5,11,9,8,30,26.7,22,14,0,14,2,27,12,1,"https://fbref.com/en/players/15ab5a2b/Julian-Alvarez"
2025,"Atlético Madrid","La Liga","César Azpilicueta","ESP","DF","35-272",1989,9.7,25,14,12,9,4,17,23,73.9,6,10,2,8,5,30,32,0,"https://fbref.com/en/players/53cad200/Cesar-Azpilicueta"
2025,"Atlético Madrid","La Liga","Pablo Barrios","ESP","MF","21-346",2003,25.9,46,26,23,20,3,23,47,48.9,24,18,5,13,34,80,33,9,"https://fbref.com/en/players/45736cec/Pablo-Barrios"
2025,"Atlético Madrid","La Liga","Ángel Correa","ARG","FW,MF","30-079",1995,8.9,9,3,4,1,4,5,15,33.3,10,10,0,10,4,13,8,0,"https://fbref.com/en/players/01eb744d/Angel-Correa"
2025,"Atlético Madrid","La Liga","Rodrigo De Paul","ARG","MF","31-003",1994,23.4,33,26,12,16,5,14,33,42.4,19,25,2,23,6,39,15,3,"https://fbref.com/en/players/162efffd/Rodrigo-De-Paul"
2025,"Atlético Madrid","La Liga","Javi Galán","ESP","DF","30-189",1994,19.8,51,31,31,15,5,25,49,51,24,13,3,10,12,63,47,0,"https://fbref.com/en/players/a4b00319/Javi-Galan"
2025,"Atlético Madrid","La Liga","Conor Gallagher","ENG","MF","25-110",2000,18.1,45,32,16,19,10,22,49,44.9,27,23,5,18,20,65,23,0,"https://fbref.com/en/players/c2731c10/Conor-Gallagher"
2025,"Atlético Madrid","La Liga","Antoine Griezmann","FRA","FW,MF","34-067",1991,27.4,30,17,13,13,4,7,29,24.1,22,20,1,19,6,36,23,1,"https://fbref.com/en/players/df69b544/Antoine-Griezmann"
2025,"Atlético Madrid","La Liga","Koke","ESP","MF","33-139",1992,21.4,46,23,18,22,6,21,43,48.8,22,24,2,22,20,66,29,2,"https://fbref.com/en/players/55126f3b/Koke"
2025,"Atlético Madrid","La Liga","Robin Le Normand","ESP","DF","28-197",1996,23.9,27,18,23,4,0,12,20,60,8,20,9,11,10,37,120,1,"https://fbref.com/en/players/9a64e67e/Robin-Le-Normand"
2025,"Atlético Madrid","La Liga","Thomas Lemar","FRA","MF","29-196",1995,0.9,2,1,1,1,0,2,4,50,2,0,0,0,0,2,1,0,"https://fbref.com/en/players/4dbd0916/Thomas-Lemar"
2025,"Atlético Madrid","La Liga","Clément Lenglet","FRA","DF","29-344",1995,21.9,27,17,19,8,0,11,15,73.3,4,24,18,6,22,49,104,1,"https://fbref.com/en/players/4f28a6ff/Clement-Lenglet"
2025,"Atlético Madrid","La Liga","Samuel Lino","BRA","MF,DF","25-155",1999,17.2,33,17,25,4,4,22,52,42.3,30,23,4,19,8,41,13,0,"https://fbref.com/en/players/2a295d33/Samuel-Lino"
2025,"Atlético Madrid","La Liga","Marcos Llorente","ESP","DF,MF","30-117",1995,27.9,69,52,38,27,4,36,55,65.5,19,32,7,25,27,96,51,1,"https://fbref.com/en/players/02c15616/Marcos-Llorente"
2025,"Atlético Madrid","La Liga","Reinildo Mandava","MOZ","DF","31-126",1994,10.5,18,11,10,7,1,10,18,55.6,8,11,5,6,16,34,35,0,"https://fbref.com/en/players/c20bdcd7/Reinildo-Mandava"
2025,"Atlético Madrid","La Liga","José María Giménez","URU","DF","30-127",1995,22.2,26,16,18,8,0,17,28,60.7,11,29,19,10,27,53,115,2,"https://fbref.com/en/players/f0da930c/Jose-Maria-Gimenez"
2025,"Atlético Madrid","La Liga","Nahuel Molina","ARG","DF","27-051",1998,17.7,44,19,21,21,2,31,56,55.4,25,16,3,13,13,57,53,0,"https://fbref.com/en/players/23610943/Nahuel-Molina"
2025,"Atlético Madrid","La Liga","Juan Musso","ARG","GK","31-021",1994,2,0,0,0,0,0,0,0,NA,0,0,0,0,0,0,0,0,"https://fbref.com/en/players/a111cf41/Juan-Musso"
2025,"Atlético Madrid","La Liga","Adrian Niño","ESP","FW","20-342",2004,0.1,0,0,0,0,0,0,0,NA,0,0,0,0,0,0,0,0,"https://fbref.com/en/players/5b9067c9/Adrian-Nino"
2025,"Atlético Madrid","La Liga","Jan Oblak","SVN","GK","32-140",1993,36,0,0,0,0,0,0,0,NA,0,0,0,0,0,0,17,2,"https://fbref.com/en/players/ee8508c0/Jan-Oblak"
2025,"Atlético Madrid","La Liga","Rodrigo Riquelme","ESP","MF,DF","25-055",2000,5.7,11,5,4,6,1,6,11,54.5,5,3,0,3,2,13,3,0,"https://fbref.com/en/players/65154df0/Rodrigo-Riquelme"
2025,"Atlético Madrid","La Liga","Giuliano Simeone","ARG","MF","22-160",2002,21.4,27,13,6,11,10,15,30,50,15,22,3,19,14,41,22,1,"https://fbref.com/en/players/a6536561/Giuliano-Simeone"
2025,"Atlético Madrid","La Liga","Alexander Sørloth","NOR","FW","29-173",1995,17.4,9,5,2,5,2,3,6,50,3,6,1,5,1,10,28,0,"https://fbref.com/en/players/e92cd3f7/Alexander-Sorloth"
2025,"Atlético Madrid","La Liga","Axel Witsel","BEL","DF","36-135",1989,9.5,16,12,4,10,2,12,14,85.7,2,15,8,7,11,27,34,1,"https://fbref.com/en/players/5dfc6ad5/Axel-Witsel"
2025,"Augsburg","Bundesliga","Noahkai Banks","USA","DF","18-177",2006,3.1,11,5,6,4,1,3,7,42.9,4,4,1,3,5,16,28,0,"https://fbref.com/en/players/118e3ac3/Noahkai-Banks"
2025,"Augsburg","Bundesliga","Maximilian Bauer","GER","DF","25-107",2000,7.3,14,8,5,7,2,9,14,64.3,5,10,4,6,6,20,35,1,"https://fbref.com/en/players/44a20f0c/Maximilian-Bauer"
2025,"Augsburg","Bundesliga","Mergim Berisha","GER","FW","27-016",1998,0.4,1,0,0,1,0,1,1,100,0,2,1,1,0,1,0,0,"https://fbref.com/en/players/eb6e14be/Mergim-Berisha"
2025,"Augsburg","Bundesliga","Tim Breithaupt","GER","MF","23-109",2002,1.3,1,1,0,1,0,0,4,0,4,1,0,1,2,3,0,0,"https://fbref.com/en/players/ed98c321/Tim-Breithaupt"
2025,"Augsburg","Bundesliga","Alexis Claude-Maurice","FRA","MF,FW","26-355",1998,23.4,41,26,12,15,14,17,34,50,17,16,0,16,15,56,8,1,"https://fbref.com/en/players/741418c3/Alexis-Claude-Maurice"
2025,"Augsburg","Bundesliga","Finn Dahmen","GER","GK","27-061",1998,19,1,0,1,0,0,1,2,50,1,0,0,0,0,1,9,0,"https://fbref.com/en/players/dee3013b/Finn-Dahmen"
2025,"Augsburg","Bundesliga","Niklas Dorsch","GER","MF","27-132",1998,0.4,0,0,0,0,0,0,0,NA,0,1,0,1,0,0,0,0,"https://fbref.com/en/players/7f73bdf4/Niklas-Dorsch"
2025,"Augsburg","Bundesliga","Arne Engels","BEL","MF,FW","21-261",2003,0.9,0,0,0,0,0,0,0,NA,0,1,1,0,0,0,0,0,"https://fbref.com/en/players/554bcc91/Arne-Engels"
2025,"Augsburg","Bundesliga","Samuel Essende","COD","FW","27-124",1998,18.2,7,6,1,3,3,3,4,75,1,13,2,11,0,7,11,1,"https://fbref.com/en/players/821550ce/Samuel-Essende"
2025,"Augsburg","Bundesliga","Dimitris Giannoulis","GRE","DF","29-222",1995,29.4,47,32,27,16,4,26,44,59.1,18,49,11,38,47,94,75,0,"https://fbref.com/en/players/112c495e/Dimitris-Giannoulis"
2025,"Augsburg","Bundesliga","Jeffrey Gouweleeuw","NED","DF","33-321",1991,32.7,50,28,25,21,4,27,40,67.5,13,34,15,19,35,85,183,0,"https://fbref.com/en/players/1025db8e/Jeffrey-Gouweleeuw"
2025,"Augsburg","Bundesliga","Robert Gumny","POL","DF","26-357",1998,3,3,3,1,2,0,2,6,33.3,4,2,0,2,1,4,6,0,"https://fbref.com/en/players/1df0c0b9/Robert-Gumny"
2025,"Augsburg","Bundesliga","Kristijan Jakić","CRO","MF","28-013",1997,25.6,46,23,20,19,7,22,43,51.2,21,42,9,33,28,74,50,1,"https://fbref.com/en/players/a8ee54ad/Kristijan-Jakic"
2025,"Augsburg","Bundesliga","Fredrik Jensen","FIN","MF","27-260",1997,8.5,7,7,1,3,3,4,5,80,1,10,1,9,4,11,17,0,"https://fbref.com/en/players/3eeb80e0/Fredrik-Jensen"
2025,"Augsburg","Bundesliga","Yusuf Kabadayı","GER","FW,MF","21-114",2004,0.8,1,0,0,1,0,0,0,NA,0,1,0,1,0,1,0,0,"https://fbref.com/en/players/a4a94bb2/Yusuf-Kabadayi"
2025,"Augsburg","Bundesliga","Mert Kömür","GER","MF","19-314",2005,7.3,3,2,2,0,1,0,3,0,3,9,3,6,3,6,7,1,"https://fbref.com/en/players/ec68a918/Mert-Komur"
2025,"Augsburg","Bundesliga","Henri Koudossou","GER","DF","25-266",1999,8.3,18,10,6,11,1,11,19,57.9,8,8,2,6,15,33,37,0,"https://fbref.com/en/players/2b9745cb/Henri-Koudossou"
2025,"Augsburg","Bundesliga","Nediljko Labrović","CRO","GK","25-229",1999,15,0,0,0,0,0,0,0,NA,0,0,0,0,0,0,12,1,"https://fbref.com/en/players/208fc867/Nediljko-Labrovic"
2025,"Augsburg","Bundesliga","Arne Maier","GER","MF","26-139",1999,10.4,13,7,4,8,1,7,13,53.8,6,15,1,14,6,19,14,1,"https://fbref.com/en/players/ab700320/Arne-Maier"
2025,"Augsburg","Bundesliga","Chrislain Matsima","FRA","DF","23-012",2002,28.3,31,20,19,11,1,17,26,65.4,9,48,29,19,52,83,163,0,"https://fbref.com/en/players/cf1ef7ec/Chrislain-Matsima"
2025,"Augsburg","Bundesliga","Steve Mounié","BEN","FW,MF","30-240",1994,3.9,4,4,0,1,3,0,1,0,1,1,1,0,1,5,5,1,"https://fbref.com/en/players/19ba6c6d/Steve-Mounie"
2025,"Augsburg","Bundesliga","Frank Onyeka","NGA","MF","27-146",1998,28.7,58,45,22,28,8,22,40,55,18,36,9,27,36,94,36,2,"https://fbref.com/en/players/2944f86f/Frank-Onyeka"
2025,"Augsburg","Bundesliga","Mads Pedersen","DEN","DF","28-268",1996,2.6,8,7,5,2,1,4,5,80,1,4,0,4,2,10,6,0,"https://fbref.com/en/players/582a5247/Mads-Pedersen"
2025,"Augsburg","Bundesliga","Elvis Rexhbeçaj","KVX","MF","27-207",1997,19.8,27,19,9,14,4,15,35,42.9,20,40,9,31,16,43,22,1,"https://fbref.com/en/players/1ae836b1/Elvis-Rexhbecaj"
2025,"Augsburg","Bundesliga","Keven Schlotterbeck","GER","DF","28-029",1997,14.4,19,17,9,9,1,12,16,75,4,13,6,7,15,34,73,1,"https://fbref.com/en/players/f6bdc830/Keven-Schlotterbeck"
2025,"Augsburg","Bundesliga","Phillip Tietz","GER","FW","27-322",1997,18.7,11,6,2,7,2,5,8,62.5,3,10,1,9,5,16,26,1,"https://fbref.com/en/players/3397e7b5/Phillip-Tietz"
2025,"Augsburg","Bundesliga","Ruben Vargas","SUI","MF,FW","26-295",1998,3.4,2,1,1,1,0,1,4,25,3,1,0,1,2,4,1,1,"https://fbref.com/en/players/6ecbddf6/Ruben-Vargas"
2025,"Augsburg","Bundesliga","Marius Wolf","GER","DF","30-000",1995,23.8,27,16,13,11,3,16,43,37.2,27,29,5,24,24,51,51,1,"https://fbref.com/en/players/fa661778/Marius-Wolf"
2025,"Augsburg","Bundesliga","Cedric Zesiger","SUI","DF","26-337",1998,13.6,13,7,7,6,0,8,13,61.5,5,17,10,7,21,34,96,1,"https://fbref.com/en/players/2bab583c/Cedric-Zesiger"
2025,"Auxerre","Ligue 1","Clément Akpa","CIV","DF","23-184",2001,27.6,55,34,36,12,7,31,46,67.4,15,38,14,24,42,97,141,2,"https://fbref.com/en/players/0abb5072/Clement-Akpa"
2025,"Auxerre","Ligue 1","Florian Ayé","FRA","FW","28-128",1997,6.4,2,2,0,0,2,0,2,0,2,7,0,7,7,9,6,0,"https://fbref.com/en/players/718b8afd/Florian-Aye"
2025,"Auxerre","Ligue 1","Theo Bair","CAN","FW","25-273",1999,10.4,4,3,1,2,1,0,2,0,2,6,2,4,3,7,10,0,"https://fbref.com/en/players/c724745e/Theo-Bair"
2025,"Auxerre","Ligue 1","Yoann Cissé","FRA","MF","20-165",2004,0.1,0,0,0,0,0,0,0,NA,0,0,0,0,1,1,0,0,"https://fbref.com/en/players/fd739131/Yoann-Cisse"
2025,"Auxerre","Ligue 1","Lasso Coulibaly","CIV","FW,MF","22-220",2002,0.5,1,1,0,0,1,0,0,NA,0,0,0,0,0,1,0,0,"https://fbref.com/en/players/78310540/Lasso-Coulibaly"
2025,"Auxerre","Ligue 1","Kévin Danois","FRA","MF","20-333",2004,16.2,49,30,20,22,7,20,46,43.5,26,17,3,14,20,69,20,0,"https://fbref.com/en/players/e76f6fbe/Kevin-Danois"
2025,"Auxerre","Ligue 1","Théo De Percin","MTQ","GK","24-114",2001,2,0,0,0,0,0,0,1,0,1,0,0,0,0,0,3,0,"https://fbref.com/en/players/afbb55d2/Theo-De-Percin"
2025,"Auxerre","Ligue 1","Sinaly Diomande","CIV","DF","24-048",2001,21.6,39,19,20,18,1,28,40,70,12,37,18,19,30,69,100,2,"https://fbref.com/en/players/6de23ab0/Sinaly-Diomande"
2025,"Auxerre","Ligue 1","Assane Dioussé","SEN","MF","27-249",1997,7.4,15,7,9,5,1,5,14,35.7,9,6,2,4,12,27,15,0,"https://fbref.com/en/players/7f622eef/Assane-Diousse"
2025,"Auxerre","Ligue 1","Ki-Jana Hoever","NED","DF","23-129",2002,23.6,51,38,26,16,9,30,54,55.6,24,33,3,30,21,72,70,1,"https://fbref.com/en/players/9a71e978/Ki-Jana-Hoever"
2025,"Auxerre","Ligue 1","Paul Joly","FRA","DF","24-354",2000,11.2,49,32,30,17,2,27,45,60,18,19,1,18,25,74,32,5,"https://fbref.com/en/players/5b4bc323/Paul-Joly"
2025,"Auxerre","Ligue 1","Jubal","BRA","DF","31-271",1993,29.3,60,39,46,13,1,28,40,70,12,61,36,25,25,85,201,1,"https://fbref.com/en/players/56ae428b/Jubal"
2025,"Auxerre","Ligue 1","Hamed Junior Traorè","CIV","MF","25-100",2000,23.3,41,20,11,17,13,16,54,29.6,38,14,0,14,8,49,11,0,"https://fbref.com/en/players/570bb4b9/Hamed-Junior-Traore"
2025,"Auxerre","Ligue 1","Donovan Léon","GUF","GK","32-205",1992,32,0,0,0,0,0,0,3,0,3,2,0,2,0,0,26,1,"https://fbref.com/en/players/51c83a90/Donovan-Leon"
2025,"Auxerre","Ligue 1","Eros Maddy","NED","DF","24-111",2001,0.2,0,0,0,0,0,0,0,NA,0,0,0,0,0,0,0,0,"https://fbref.com/en/players/0ed50019/Eros-Maddy"
2025,"Auxerre","Ligue 1","Han-Noah Massengo","FRA","MF","23-324",2001,11.6,17,11,5,8,4,8,12,66.7,4,12,4,8,17,34,10,2,"https://fbref.com/en/players/eba1e557/Han-Noah-Massengo"
2025,"Auxerre","Ligue 1","Rudy Matondo","FRA","MF","17-075",2008,0.7,1,1,1,0,0,0,1,0,1,0,0,0,0,1,2,0,"https://fbref.com/en/players/64b170af/Rudy-Matondo"
2025,"Auxerre","Ligue 1","Gideon Mensah","GHA","DF","26-313",1998,25.3,68,45,37,21,10,33,66,50,33,27,4,23,50,118,83,0,"https://fbref.com/en/players/9bdd8118/Gideon-Mensah"
2025,"Auxerre","Ligue 1","Loïc N'Gatta","FRA","DF","21-167",2003,0.1,1,1,0,1,0,1,2,50,1,1,0,1,0,1,1,0,"https://fbref.com/en/players/b1fe3000/Loic-NGatta"
2025,"Auxerre","Ligue 1","Ado Onaiwu","JPN","MF,FW","29-200",1995,10.6,11,7,2,6,3,4,14,28.6,10,12,0,12,3,14,12,0,"https://fbref.com/en/players/ff4df82e/Ado-Onaiwu"
2025,"Auxerre","Ligue 1","Fredrik Oppegard","NOR","DF","22-293",2002,3,6,4,4,1,1,3,7,42.9,4,2,1,1,2,8,12,1,"https://fbref.com/en/players/c0347e9b/Fredrik-Oppegard"
2025,"Auxerre","Ligue 1","Gabriel Osho","NGA","DF","26-286",1998,18.4,23,15,17,3,3,13,20,65,7,32,19,13,12,35,87,0,"https://fbref.com/en/players/cd889153/Gabriel-Osho"
2025,"Auxerre","Ligue 1","Elisha Owusu","GHA","MF","27-201",1997,26,73,41,29,39,5,31,48,64.6,17,33,9,24,42,115,35,1,"https://fbref.com/en/players/e2781082/Elisha-Owusu"
2025,"Auxerre","Ligue 1","Théo Pellenard","FRA","DF","31-084",1994,0.5,3,2,2,1,0,1,3,33.3,2,1,0,1,0,3,3,0,"https://fbref.com/en/players/97fb4608/Theo-Pellenard"
2025,"Auxerre","Ligue 1","Gaëtan Perrin","FRA","MF,FW","28-354",1996,29.9,49,26,22,12,15,21,48,43.8,27,10,0,10,12,61,4,1,"https://fbref.com/en/players/10dd88f9/Gaetan-Perrin"
2025,"Auxerre","Ligue 1","Rayan Raveloson","MAD","MF,DF","28-131",1997,8,6,5,2,4,0,5,15,33.3,10,8,7,1,5,11,22,0,"https://fbref.com/en/players/fb3236a7/Rayan-Raveloson"
2025,"Auxerre","Ligue 1","Lassine Sinayoko","MLI","FW,MF","25-170",1999,25.5,33,20,10,14,9,11,23,47.8,12,16,2,14,13,46,38,0,"https://fbref.com/en/players/5e5249c8/Lassine-Sinayoko"
2025,"Auxerre","Ligue 1","Ben Viadere","FRA","MF","19-267",2005,0.1,0,0,0,0,0,0,0,NA,0,0,0,0,0,0,0,0,"https://fbref.com/en/players/88fe0c2d/Ben-Viadere"
2025,"Auxerre","Ligue 1","Aristide Zossou","CIV","MF","19-347",2005,0.2,0,0,0,0,0,0,0,NA,0,0,0,0,0,0,0,0,"https://fbref.com/en/players/3dcd9017/Aristide-Zossou"
2025,"Barcelona","La Liga","Ronald Araújo","URU","DF","26-081",1999,8.4,12,9,6,5,1,4,5,80,1,6,4,2,9,21,25,0,"https://fbref.com/en/players/2bef2bca/Ronald-Araujo"
2025,"Barcelona","La Liga","Alejandro Balde","ESP","DF","21-221",2003,25.4,18,10,10,5,3,11,17,64.7,6,24,5,19,5,23,27,0,"https://fbref.com/en/players/5ccc9672/Alejandro-Balde"
2025,"Barcelona","La Liga","Marc Bernal","ESP","MF","18-001",2007,2.7,8,6,2,5,1,7,8,87.5,1,5,1,4,1,9,4,0,"https://fbref.com/en/players/29117812/Marc-Bernal"
2025,"Barcelona","La Liga","Marc Casado","ESP","MF","21-255",2003,17.9,44,25,7,30,7,20,41,48.8,21,20,5,15,22,66,22,1,"https://fbref.com/en/players/2ef08833/Marc-Casado"
2025,"Barcelona","La Liga","Andreas Christensen","DEN","DF","29-047",1996,2.8,6,4,4,1,1,4,4,100,0,2,0,2,4,10,9,0,"https://fbref.com/en/players/1cb49278/Andreas-Christensen"
2025,"Barcelona","La Liga","Pau Cubarsí","ESP","DF","18-125",2007,29.1,34,23,21,10,3,19,30,63.3,11,12,9,3,16,50,86,1,"https://fbref.com/en/players/cc7888f3/Pau-Cubarsi"
2025,"Barcelona","La Liga","Sergi Dominguez","ESP","DF","20-056",2005,1.9,1,1,1,0,0,0,0,NA,0,0,0,0,3,4,7,0,"https://fbref.com/en/players/88507352/Sergi-Dominguez"
2025,"Barcelona","La Liga","Ansu Fati","ESP","FW","22-208",2002,2.6,4,1,0,2,2,1,2,50,1,1,0,1,1,5,0,1,"https://fbref.com/en/players/0ba976e4/Ansu-Fati"
2025,"Barcelona","La Liga","Héctor Fort","ESP","DF","18-298",2006,6.5,13,8,6,4,3,10,16,62.5,6,12,0,12,6,19,16,0,"https://fbref.com/en/players/2e31f3a6/Hector-Fort"
2025,"Barcelona","La Liga","Eric García","ESP","DF,MF","24-138",2001,17.4,38,21,11,24,3,20,29,69,9,24,8,16,14,52,41,0,"https://fbref.com/en/players/2bed3eab/Eric-Garcia"
2025,"Barcelona","La Liga","Gavi","ESP","MF,FW","20-295",2004,12.1,30,21,10,15,5,15,26,57.7,11,14,1,13,10,40,7,0,"https://fbref.com/en/players/19cae58d/Gavi"
2025,"Barcelona","La Liga","Frenkie de Jong","NED","MF","28-015",1997,12.7,19,11,5,8,6,8,16,50,8,9,1,8,12,31,7,1,"https://fbref.com/en/players/1bacc518/Frenkie-de-Jong"
2025,"Barcelona","La Liga","Jules Koundé","FRA","DF","26-196",1998,28.9,63,43,29,23,11,44,66,66.7,22,35,5,30,20,83,68,2,"https://fbref.com/en/players/4d1666ff/Jules-Kounde"
2025,"Barcelona","La Liga","Robert Lewandowski","POL","FW","36-279",1988,29.6,10,5,1,5,4,5,11,45.5,6,14,2,12,3,13,26,0,"https://fbref.com/en/players/8d78e732/Robert-Lewandowski"
2025,"Barcelona","La Liga","Fermin López","ESP","MF,FW","22-016",2003,13.9,19,15,3,9,7,8,32,25,24,11,0,11,5,24,3,0,"https://fbref.com/en/players/c1fe5f0b/Fermin-Lopez"
2025,"Barcelona","La Liga","Gerard Martín","ESP","DF","23-146",2002,11.5,22,10,10,7,5,11,16,68.8,5,16,2,14,13,35,27,0,"https://fbref.com/en/players/b792c59d/Gerard-Martin"
2025,"Barcelona","La Liga","Iñigo Martínez","ESP","DF","34-010",1991,27.7,25,14,20,5,0,16,22,72.7,6,18,7,11,18,43,108,1,"https://fbref.com/en/players/3fc45c73/Inigo-Martinez"
2025,"Barcelona","La Liga","Dani Olmo","ESP","MF,FW","27-020",1998,13.5,16,11,8,5,3,4,14,28.6,10,6,3,3,3,19,11,1,"https://fbref.com/en/players/ae44e8e2/Dani-Olmo"
2025,"Barcelona","La Liga","Pedri","ESP","MF","22-183",2002,32,61,34,14,38,9,24,70,34.3,46,45,3,42,26,87,21,1,"https://fbref.com/en/players/0d9b2d31/Pedri"
2025,"Barcelona","La Liga","Iñaki Peña","ESP","GK","26-086",1999,15.5,0,0,0,0,0,0,2,0,2,0,0,0,0,0,20,1,"https://fbref.com/en/players/cc1c5035/Inaki-Pena"
2025,"Barcelona","La Liga","Raphinha","BRA","FW,MF","28-164",1996,31.5,36,22,6,19,11,19,39,48.7,20,29,2,27,11,47,26,0,"https://fbref.com/en/players/3423f250/Raphinha"
2025,"Barcelona","La Liga","Daniel Rodriguez","ESP","FW","19-291",2005,0.4,0,0,0,0,0,0,0,NA,0,1,0,1,0,0,0,0,"https://fbref.com/en/players/f9cbad15/Daniel-Rodriguez"
2025,"Barcelona","La Liga","Wojciech Szczęsny","POL","GK","35-039",1990,15,1,1,1,0,0,0,0,NA,0,0,0,0,0,1,20,1,"https://fbref.com/en/players/01b8a2b2/Wojciech-Szczesny"
2025,"Barcelona","La Liga","Marc-André ter Stegen","GER","GK","33-027",1992,7.5,0,0,0,0,0,0,1,0,1,0,0,0,0,0,2,2,"https://fbref.com/en/players/6f51e382/Marc-Andre-ter-Stegen"
2025,"Barcelona","La Liga","Pablo Torre","ESP","MF,FW","22-054",2003,3.4,5,4,1,3,1,2,4,50,2,0,0,0,3,8,5,1,"https://fbref.com/en/players/04e531b6/Pablo-Torre"
2025,"Barcelona","La Liga","Ferrán Torres","ESP","FW,MF","25-087",2000,12.3,8,4,2,3,3,3,8,37.5,5,7,1,6,4,12,5,0,"https://fbref.com/en/players/9e1035f8/Ferran-Torres"
2025,"Barcelona","La Liga","Pau Victor Delgado","ESP","FW","23-182",2001,3.5,3,1,0,2,1,0,3,0,3,6,1,5,2,5,5,0,"https://fbref.com/en/players/e6e7c819/Pau-Victor-Delgado"
2025,"Barcelona","La Liga","Lamine Yamal","ESP","FW","17-318",2007,31.7,42,28,8,17,17,16,38,42.1,22,12,0,12,16,58,3,0,"https://fbref.com/en/players/82ec26c1/Lamine-Yamal"
2025,"Bayern Munich","Bundesliga","Adam Aznou","MAR","DF","18-359",2006,0.2,0,0,0,0,0,0,0,NA,0,0,0,0,0,0,1,0,"https://fbref.com/en/players/e678d983/Adam-Aznou"
2025,"Bayern Munich","Bundesliga","Sacha Boey","FRA","DF","24-256",2000,6.6,20,5,6,6,8,13,18,72.2,5,6,0,6,2,22,14,0,"https://fbref.com/en/players/6c8ddd52/Sacha-Boey"
2025,"Bayern Munich","Bundesliga","Kingsley Coman","FRA","FW","28-348",1996,14.2,17,12,6,6,5,8,12,66.7,4,12,0,12,8,25,15,0,"https://fbref.com/en/players/042e8a49/Kingsley-Coman"
2025,"Bayern Munich","Bundesliga","Alphonso Davies","CAN","DF","24-206",2000,17.3,30,17,7,17,6,17,26,65.4,9,14,1,13,13,43,22,2,"https://fbref.com/en/players/d781d855/Alphonso-Davies"
2025,"Bayern Munich","Bundesliga","Eric Dier","ENG","DF","31-132",1994,16.3,19,11,8,9,2,13,20,65,7,19,8,11,20,39,77,1,"https://fbref.com/en/players/ac861941/Eric-Dier"
2025,"Bayern Munich","Bundesliga","Serge Gnabry","GER","FW,MF","29-317",1995,13.8,20,11,6,7,7,8,12,66.7,4,11,0,11,6,26,9,0,"https://fbref.com/en/players/88e357ef/Serge-Gnabry"
2025,"Bayern Munich","Bundesliga","Leon Goretzka","GER","MF,DF","30-110",1995,14.7,21,11,5,12,4,10,20,50,10,27,7,20,20,41,25,1,"https://fbref.com/en/players/cc86b9a3/Leon-Goretzka"
2025,"Bayern Munich","Bundesliga","Raphaël Guerreiro","POR","DF,MF","31-156",1993,17.5,19,12,9,7,3,12,16,75,4,9,0,9,10,29,19,1,"https://fbref.com/en/players/048a1cbc/Raphael-Guerreiro"
2025,"Bayern Munich","Bundesliga","Arijon Ibrahimović","GER","FW","19-167",2005,0,0,0,0,0,0,0,0,NA,0,0,0,0,0,0,0,0,"https://fbref.com/en/players/f5c4fd91/Arijon-Ibrahimovic"
2025,"Bayern Munich","Bundesliga","Hiroki Ito","JPN","DF","26-015",1999,2.8,2,0,1,1,0,1,1,100,0,3,2,1,6,8,15,1,"https://fbref.com/en/players/204dded0/Hiroki-Ito"
2025,"Bayern Munich","Bundesliga","Harry Kane","ENG","FW","31-303",1993,26.5,13,11,3,8,2,2,6,33.3,4,16,2,14,2,15,16,0,"https://fbref.com/en/players/21a66f6a/Harry-Kane"
2025,"Bayern Munich","Bundesliga","Joshua Kimmich","GER","MF","30-108",1995,31.6,47,29,11,29,7,30,50,60,20,23,3,20,25,72,34,3,"https://fbref.com/en/players/49296448/Joshua-Kimmich"
2025,"Bayern Munich","Bundesliga","Jonah Kusi-Asare","SWE","FW","17-327",2007,0,1,0,0,0,1,0,0,NA,0,0,0,0,0,1,0,0,"https://fbref.com/en/players/c7c26e61/Jonah-Kusi-Asare"
2025,"Bayern Munich","Bundesliga","Konrad Laimer","AUT","DF","28-000",1997,18.9,49,27,19,22,8,23,48,47.9,25,24,1,23,8,57,24,1,"https://fbref.com/en/players/c1b7847c/Konrad-Laimer"
2025,"Bayern Munich","Bundesliga","Kim Min-jae","KOR","DF","28-193",1996,25.4,35,20,18,13,4,11,21,52.4,10,23,10,13,37,72,91,4,"https://fbref.com/en/players/e0f8151c/Kim-Min-jae"
2025,"Bayern Munich","Bundesliga","Thomas Müller","GER","MF,FW","35-256",1989,13.6,8,5,2,3,3,4,16,25,12,10,0,10,2,10,14,0,"https://fbref.com/en/players/3c6089ab/Thomas-Muller"
2025,"Bayern Munich","Bundesliga","Jamal Musiala","GER","MF","22-090",2003,20,36,21,7,16,13,12,29,41.4,17,30,0,30,8,44,5,1,"https://fbref.com/en/players/2c0558b8/Jamal-Musiala"
2025,"Bayern Munich","Bundesliga","Manuel Neuer","GER","GK","39-061",1986,22,1,0,1,0,0,1,1,100,0,0,0,0,0,1,9,1,"https://fbref.com/en/players/8778c910/Manuel-Neuer"
2025,"Bayern Munich","Bundesliga","Michael Olise","FRA","FW,MF","23-166",2001,25.9,36,23,10,21,5,17,38,44.7,21,23,1,22,8,44,16,2,"https://fbref.com/en/players/c4486bac/Michael-Olise"
2025,"Bayern Munich","Bundesliga","João Palhinha","POR","MF","29-322",1995,7.5,20,14,6,11,3,11,16,68.8,5,13,1,12,4,24,9,1,"https://fbref.com/en/players/a78ff07f/Joao-Palhinha"
2025,"Bayern Munich","Bundesliga","Aleksandar Pavlovic","GER","MF","21-024",2004,16.1,38,21,13,15,10,22,32,68.8,10,18,3,15,5,43,14,0,"https://fbref.com/en/players/2658c82f/Aleksandar-Pavlovic"
2025,"Bayern Munich","Bundesliga","Daniel Peretz","ISR","GK","24-321",2000,3,0,0,0,0,0,0,1,0,1,0,0,0,0,0,2,0,"https://fbref.com/en/players/3f29b3ba/Daniel-Peretz"
2025,"Bayern Munich","Bundesliga","Leroy Sané","GER","FW","29-136",1996,18.2,23,15,4,8,11,12,23,52.2,11,8,0,8,7,30,3,0,"https://fbref.com/en/players/2b114be3/Leroy-Sane"
2025,"Bayern Munich","Bundesliga","Josip Stanišić","CRO","DF","25-055",2000,9.7,13,11,6,4,3,7,15,46.7,8,10,6,4,6,19,29,1,"https://fbref.com/en/players/7ed08d5c/Josip-Stanisic"
2025,"Bayern Munich","Bundesliga","Mathys Tel","FRA","FW,MF","20-030",2005,2.8,2,2,0,2,0,0,0,NA,0,0,0,0,1,3,1,0,"https://fbref.com/en/players/829aa60c/Mathys-Tel"
2025,"Bayern Munich","Bundesliga","Sven Ulreich","GER","GK","36-297",1988,1,0,0,0,0,0,0,0,NA,0,0,0,0,0,0,0,0,"https://fbref.com/en/players/7d3e7da6/Sven-Ulreich"
2025,"Bayern Munich","Bundesliga","Dayot Upamecano","FRA","DF","26-212",1998,19.5,36,22,18,16,2,16,29,55.2,13,17,7,10,34,70,45,1,"https://fbref.com/en/players/d248cd8f/Dayot-Upamecano"
2025,"Bayern Munich","Bundesliga","Jonas Urbig","GER","GK","21-292",2003,8,0,0,0,0,0,0,0,NA,0,0,0,0,0,0,9,2,"https://fbref.com/en/players/925bbcdc/Jonas-Urbig"
2025,"Bayern Munich","Bundesliga","Gabriel Vidovic","CRO","MF","21-177",2003,0.3,0,0,0,0,0,0,0,NA,0,2,0,2,0,0,0,0,"https://fbref.com/en/players/5360a956/Gabriel-Vidovic"
2025,"Betis","La Liga","Adrián","ESP","GK","38-144",1987,19,0,0,0,0,0,0,3,0,3,0,0,0,0,0,14,3,"https://fbref.com/en/players/f76e6b4e/Adrian"
2025,"Betis","La Liga","Sergi Altimira","ESP","MF","23-275",2001,21.9,61,37,17,38,6,36,60,60,24,28,1,27,24,85,43,3,"https://fbref.com/en/players/94acdd4e/Sergi-Altimira"
2025,"Betis","La Liga","Antony","BRA","FW","25-092",2000,15.1,25,11,6,9,10,8,22,36.4,14,12,1,11,10,35,9,1,"https://fbref.com/en/players/99127249/Antony"
2025,"Betis","La Liga","Sergio Arribas","ESP","DF","22-106",2003,1,7,4,4,3,0,6,7,85.7,1,2,2,0,3,10,4,0,"https://fbref.com/en/players/ff31f01f/Sergio-Arribas"
2025,"Betis","La Liga","Ezequiel Ávila","ARG","FW","31-110",1994,7.5,8,3,2,2,4,4,10,40,6,4,0,4,2,10,8,0,"https://fbref.com/en/players/253a06b9/Ezequiel-Avila"
2025,"Betis","La Liga","Cédric Bakambu","COD","FW","34-046",1991,7.9,6,4,0,5,1,3,7,42.9,4,13,2,11,0,6,5,0,"https://fbref.com/en/players/0af4dcf0/Cedric-Bakambu"
2025,"Betis","La Liga","Marc Bartra","ESP","DF","34-132",1991,23.3,33,19,20,13,0,15,26,57.7,11,41,25,16,33,66,148,0,"https://fbref.com/en/players/b742cc0d/Marc-Bartra"
2025,"Betis","La Liga","Héctor Bellerín","ESP","DF","30-069",1995,6.4,13,7,7,4,2,10,17,58.8,7,5,3,2,6,19,21,0,"https://fbref.com/en/players/f874dd44/Hector-Bellerin"
2025,"Betis","La Liga","Johnny Cardoso","USA","MF","23-249",2001,23.8,55,31,12,35,8,20,52,38.5,32,27,12,15,48,103,64,1,"https://fbref.com/en/players/7426f085/Johnny-Cardoso"
2025,"Betis","La Liga","William Carvalho","POR","MF","33-050",1992,5.4,9,6,3,6,0,4,6,66.7,2,6,2,4,3,12,6,0,"https://fbref.com/en/players/dee86451/William-Carvalho"
2025,"Betis","La Liga","Cucho","COL","FW","26-037",1999,12.7,15,10,2,5,8,6,11,54.5,5,13,1,12,7,22,4,0,"https://fbref.com/en/players/71b47ab9/Cucho"
2025,"Betis","La Liga","Assane Diao","SEN","FW","19-262",2005,3.1,5,3,1,3,1,4,9,44.4,5,3,0,3,0,5,3,0,"https://fbref.com/en/players/8ae7d0ec/Assane-Diao"
2025,"Betis","La Liga","Abde Ezzalzouli","MAR","FW,MF","23-161",2001,22,37,25,17,16,4,15,27,55.6,12,22,3,19,7,44,19,0,"https://fbref.com/en/players/bed68338/Abde-Ezzalzouli"
2025,"Betis","La Liga","Nabil Fekir","FRA","MF","31-313",1993,2,3,2,1,1,1,1,2,50,1,2,0,2,0,3,0,0,"https://fbref.com/en/players/bece776f/Nabil-Fekir"
2025,"Betis","La Liga","Mateo Flores","ESP","MF","21-050",2004,1.7,3,1,3,0,0,1,1,100,0,1,0,1,2,5,3,0,"https://fbref.com/en/players/90dcf851/Mateo-Flores"
2025,"Betis","La Liga","Pablo Fornals","ESP","MF,FW","29-094",1996,20.3,21,13,12,6,3,10,30,33.3,20,24,4,20,23,44,15,1,"https://fbref.com/en/players/82927de4/Pablo-Fornals"
2025,"Betis","La Liga","Pablo Garcia","ESP","FW","18-285",2006,0.4,0,0,0,0,0,0,0,NA,0,1,0,1,0,0,0,0,"https://fbref.com/en/players/9925419c/Pablo-Garcia"
2025,"Betis","La Liga","Carlos Guirao","ESP","MF","22-030",2003,1.2,5,3,1,4,0,4,6,66.7,2,1,1,0,3,8,2,0,"https://fbref.com/en/players/4d9f02df/Carlos-Guirao"
2025,"Betis","La Liga","Isco","ESP","MF","33-036",1992,17.2,20,13,3,13,4,7,28,25,21,10,0,10,11,31,7,0,"https://fbref.com/en/players/a0b4bb3e/Isco"
2025,"Betis","La Liga","Juanmi","ESP","FW,MF","32-007",1993,2.7,7,4,3,3,1,4,6,66.7,2,4,0,4,1,8,4,0,"https://fbref.com/en/players/84399660/Juanmi"
2025,"Betis","La Liga","Diego Llorente","ESP","DF","31-284",1993,28,36,20,23,12,1,25,38,65.8,13,29,20,9,43,79,154,1,"https://fbref.com/en/players/bba30585/Diego-Llorente"
2025,"Betis","La Liga","Giovani Lo Celso","ARG","MF,FW","29-048",1996,16.2,34,22,8,17,9,17,25,68,8,14,2,12,5,39,3,1,"https://fbref.com/en/players/d7553721/Giovani-Lo-Celso"
2025,"Betis","La Liga","Iker Losada","ESP","MF,FW","23-299",2001,3.7,10,7,2,4,4,5,10,50,5,2,0,2,3,13,2,0,"https://fbref.com/en/players/41521385/Iker-Losada"
2025,"Betis","La Liga","Nobel Mendy","FRA","DF","20-266",2004,1.2,0,0,0,0,0,0,0,NA,0,2,0,2,4,4,10,1,"https://fbref.com/en/players/7e64e657/Nobel-Mendy"
2025,"Betis","La Liga","Natan","BRA","DF","24-110",2001,24.2,35,24,24,9,2,26,30,86.7,4,24,14,10,28,63,123,2,"https://fbref.com/en/players/94bccc82/Natan"
2025,"Betis","La Liga","Ángel Ortíz","ESP","DF","20-306",2004,3.9,12,8,8,3,1,8,17,47.1,9,6,0,6,5,17,7,0,"https://fbref.com/en/players/a2f3bbb9/Angel-Ortiz"
2025,"Betis","La Liga","Romain Perraud","FRA","DF","27-247",1997,22.2,36,22,15,16,5,21,46,45.7,25,18,4,14,22,58,71,1,"https://fbref.com/en/players/6dfd8f05/Romain-Perraud"
2025,"Betis","La Liga","Marc Roca","ESP","MF","28-182",1996,10.1,20,14,10,9,1,9,17,52.9,8,17,5,12,14,34,14,2,"https://fbref.com/en/players/da27e268/Marc-Roca"
2025,"Betis","La Liga","Rodri","ESP","FW","25-011",2000,1.3,2,1,1,1,0,1,2,50,1,2,1,1,1,3,1,1,"https://fbref.com/en/players/85bed4ee/Rodri"
2025,"Betis","La Liga","Jesus Rodríguez","ESP","FW","19-187",2005,12.3,16,14,6,6,4,5,18,27.8,13,16,0,16,6,22,3,0,"https://fbref.com/en/players/f9f74e43/Jesus-Rodriguez"
2025,"Betis","La Liga","Ricardo Rodríguez","SUI","DF","32-275",1992,14.2,28,15,16,5,7,17,26,65.4,9,10,1,9,8,36,51,0,"https://fbref.com/en/players/7f78ad23/Ricardo-Rodriguez"
2025,"Betis","La Liga","Vitor Roque","BRA","FW","20-088",2005,13.7,11,6,1,6,4,1,5,20,4,5,0,5,7,18,4,0,"https://fbref.com/en/players/cb00f1e6/Vitor-Roque"
2025,"Betis","La Liga","Aitor Ruibal","ESP","DF,FW","29-066",1996,14.6,32,23,22,4,6,25,47,53.2,22,20,5,15,14,46,40,1,"https://fbref.com/en/players/a55d8df5/Aitor-Ruibal"
2025,"Betis","La Liga","Youssouf Sabaly","SEN","DF","32-083",1993,17.6,40,25,21,15,4,24,32,75,8,21,4,17,13,53,40,0,"https://fbref.com/en/players/fbbb9269/Youssouf-Sabaly"
2025,"Betis","La Liga","Rui Silva","POR","GK","31-109",1994,15,0,0,0,0,0,0,1,0,1,1,0,1,0,0,7,0,"https://fbref.com/en/players/ea83bfa6/Rui-Silva"
2025,"Betis","La Liga","Fran Vieites","ESP","GK","26-020",1999,4,0,0,0,0,0,0,0,NA,0,0,0,0,0,0,1,0,"https://fbref.com/en/players/2ae958ab/Fran-Vieites"
2025,"Bochum","Bundesliga","Aliou Badara Baldé","GUI","MF,FW","22-166",2002,1,1,1,1,0,0,0,0,NA,0,2,0,2,0,1,0,0,"https://fbref.com/en/players/7362a6f2/Aliou-Badara-Balde"
2025,"Bochum","Bundesliga","Samuel Bamba","GER","FW,MF","21-103",2004,0.3,1,1,1,0,0,0,0,NA,0,0,0,0,0,1,0,0,"https://fbref.com/en/players/489d4867/Samuel-Bamba"
2025,"Bochum","Bundesliga","Bernardo","BRA","DF","30-013",1995,19.8,46,28,32,13,1,27,37,73,10,38,17,21,26,72,103,4,"https://fbref.com/en/players/17370b95/Bernardo"
2025,"Bochum","Bundesliga","Matúš Bero","SVK","MF","29-263",1995,28.5,65,35,33,21,11,29,60,48.3,31,37,9,28,17,82,35,1,"https://fbref.com/en/players/b5e0af76/Matus-Bero"
2025,"Bochum","Bundesliga","Myron Boadu","NED","FW","24-133",2001,11.6,2,1,0,0,2,1,5,20,4,3,0,3,1,3,4,0,"https://fbref.com/en/players/5b479568/Myron-Boadu"
2025,"Bochum","Bundesliga","Moritz Broschinski","GER","FW,MF","24-246",2000,15.4,19,14,6,6,7,6,15,40,9,18,0,18,1,20,18,0,"https://fbref.com/en/players/bbd79358/Moritz-Broschinski"
2025,"Bochum","Bundesliga","Lukas Daschner","GER","MF,FW","26-238",1998,4.6,4,2,1,2,1,2,9,22.2,7,5,0,5,0,4,5,0,"https://fbref.com/en/players/93a8c4f9/Lukas-Daschner"
2025,"Bochum","Bundesliga","Patrick Drewes","GER","GK","32-112",1993,21,0,0,0,0,0,0,1,0,1,1,0,1,0,0,11,1,"https://fbref.com/en/players/a8403737/Patrick-Drewes"
2025,"Bochum","Bundesliga","Cristian Gamboa","CRC","DF","35-215",1989,2.5,8,3,5,3,0,3,9,33.3,6,2,0,2,2,10,8,0,"https://fbref.com/en/players/f27680d9/Cristian-Gamboa"
2025,"Bochum","Bundesliga","Philipp Hofmann","GER","FW","32-058",1993,25.3,17,12,4,6,7,8,15,53.3,7,14,1,13,4,21,33,0,"https://fbref.com/en/players/877bc844/Philipp-Hofmann"
2025,"Bochum","Bundesliga","Gerrit Holtmann","PHI","DF,FW","30-063",1995,12.6,24,19,14,8,2,12,24,50,12,18,5,13,16,40,15,0,"https://fbref.com/en/players/2979c05a/Gerrit-Holtmann"
2025,"Bochum","Bundesliga","Timo Horn","GER","GK","32-015",1993,13,0,0,0,0,0,0,0,NA,0,0,0,0,0,0,9,2,"https://fbref.com/en/players/3cd9e95a/Timo-Horn"
2025,"Bochum","Bundesliga","Kacper Koscierski","GER","DF","17-338",2007,0.1,0,0,0,0,0,0,0,NA,0,0,0,0,0,0,0,0,"https://fbref.com/en/players/68dca6f9/Kacper-Koscierski"
2025,"Bochum","Bundesliga","Tom Krauß","GER","MF","23-339",2001,12,35,18,20,13,2,19,38,50,19,26,2,24,11,46,19,1,"https://fbref.com/en/players/9f77012e/Tom-Krauss"
2025,"Bochum","Bundesliga","Moritz-Broni Kwarteng","GHA","MF,FW","27-029",1998,1.9,4,3,1,1,2,1,2,50,1,0,0,0,0,4,1,0,"https://fbref.com/en/players/1e2057aa/Moritz-Broni-Kwarteng"
2025,"Bochum","Bundesliga","Anthony Losilla","FRA","MF","39-078",1986,12.6,30,16,15,12,3,17,33,51.5,16,22,7,15,18,48,27,1,"https://fbref.com/en/players/07c7eb0c/Anthony-Losilla"
2025,"Bochum","Bundesliga","Giorgos Masouras","GRE","FW,MF","31-146",1994,11.7,18,10,6,7,5,7,16,43.8,9,9,1,8,4,22,3,1,"https://fbref.com/en/players/9d689a5b/Giorgos-Masouras"
2025,"Bochum","Bundesliga","Erhan Mašović","SRB","DF","26-186",1998,10.1,14,10,10,4,0,13,28,46.4,15,17,11,6,12,26,55,0,"https://fbref.com/en/players/a396fb61/Erhan-Masovic"
2025,"Bochum","Bundesliga","Jakov Medić","CRO","DF","26-262",1998,17.8,13,11,9,3,1,8,18,44.4,10,32,21,11,22,35,111,4,"https://fbref.com/en/players/5f5ebdae/Jakov-Medic"
2025,"Bochum","Bundesliga","Koji Miyoshi","JPN","FW,MF","28-062",1997,5.2,8,5,2,1,5,4,9,44.4,5,10,1,9,2,10,2,0,"https://fbref.com/en/players/77bf714c/Koji-Miyoshi"
2025,"Bochum","Bundesliga","Tim Oermann","GER","DF","21-233",2003,24.6,50,31,25,21,4,26,43,60.5,17,32,16,16,22,72,64,0,"https://fbref.com/en/players/57ec75bf/Tim-Oermann"
2025,"Bochum","Bundesliga","Ivan Ordets","UKR","DF","32-323",1992,20.7,18,8,13,5,0,10,13,76.9,3,29,16,13,41,59,139,3,"https://fbref.com/en/players/86c75897/Ivan-Ordets"
2025,"Bochum","Bundesliga","Mats Pannewig","GER","MF","20-211",2004,3,10,6,7,3,0,3,12,25,9,8,1,7,2,12,8,0,"https://fbref.com/en/players/2420dbac/Mats-Pannewig"
2025,"Bochum","Bundesliga","Felix Passlack","GER","DF,MF","26-363",1998,25.9,53,23,32,13,8,30,55,54.5,25,42,11,31,18,71,63,1,"https://fbref.com/en/players/5c899683/Felix-Passlack"
2025,"Bochum","Bundesliga","Ibrahima Sissoko","MLI","MF","27-212",1997,29,66,44,30,31,5,24,45,53.3,21,39,11,28,36,102,61,0,"https://fbref.com/en/players/0f8418aa/Ibrahima-Sissoko"
2025,"Bochum","Bundesliga","Dani de Wit","NED","MF,FW","27-119",1998,12.8,29,17,11,15,3,18,31,58.1,13,17,4,13,12,41,23,1,"https://fbref.com/en/players/48a2b92a/Dani-de-Wit"
2025,"Bochum","Bundesliga","Maximilian Wittek","GER","DF","29-279",1995,30.1,65,42,40,19,6,38,54,70.4,16,54,8,46,27,92,89,3,"https://fbref.com/en/players/edb2712b/Maximilian-Wittek"
2025,"Bologna","Serie A","Michel Aebischer","SUI","MF","28-141",1997,8,18,13,8,7,3,10,14,71.4,4,4,1,3,7,25,6,0,"https://fbref.com/en/players/f9c927de/Michel-Aebischer"
2025,"Bologna","Serie A","Oussama El Azzouzi","MAR","MF","23-363",2001,0.2,0,0,0,0,0,0,0,NA,0,0,0,0,2,2,0,0,"https://fbref.com/en/players/85f476cc/Oussama-El-Azzouzi"
2025,"Bologna","Serie A","Sam Beukema","NED","DF","26-191",1998,33.5,54,29,27,24,3,22,41,53.7,19,36,21,15,30,84,111,0,"https://fbref.com/en/players/de13cee5/Sam-Beukema"
2025,"Bologna","Serie A","Davide Calabria","ITA","DF","28-172",1996,7,12,8,5,5,2,5,12,41.7,7,4,0,4,3,15,22,1,"https://fbref.com/en/players/2146785a/Davide-Calabria"
2025,"Bologna","Serie A","Nicolò Cambiaghi","ITA","FW","24-150",2000,6.9,16,10,6,7,3,5,10,50,5,9,0,9,2,18,2,0,"https://fbref.com/en/players/91ff775f/Nicolo-Cambiaghi"
2025,"Bologna","Serie A","Nicolò Casale","ITA","DF","27-102",1998,10,11,5,4,6,1,5,10,50,5,15,7,8,17,28,43,3,"https://fbref.com/en/players/3f5f38fb/Nicolo-Casale"
2025,"Bologna","Serie A","Santiago Castro","ARG","FW","20-240",2004,25.5,18,10,4,9,5,6,17,35.3,11,13,2,11,3,21,20,0,"https://fbref.com/en/players/ee5565ae/Santiago-Castro"
2025,"Bologna","Serie A","Thijs Dallinga","NED","FW","24-297",2000,12.8,10,5,0,4,6,3,3,100,0,10,1,9,1,11,13,1,"https://fbref.com/en/players/b70afb45/Thijs-Dallinga"
2025,"Bologna","Serie A","Lorenzo De Silvestri","ITA","DF","37-004",1988,11.8,11,6,7,1,3,7,16,43.8,9,12,4,8,10,21,32,0,"https://fbref.com/en/players/e74f0e59/Lorenzo-De-Silvestri"
2025,"Bologna","Serie A","Benjamín Domínguez","ARG","FW","21-250",2003,14.2,18,7,2,11,5,6,20,30,14,15,1,14,4,22,7,0,"https://fbref.com/en/players/a83b47fa/Benjamin-Dominguez"
2025,"Bologna","Serie A","Martin Erlic","CRO","DF","27-123",1998,3.7,2,0,0,2,0,1,2,50,1,5,4,1,2,4,9,0,"https://fbref.com/en/players/0fee6bda/Martin-Erlic"
2025,"Bologna","Serie A","Estanis","ESP","FW","21-276",2003,0.1,0,0,0,0,0,0,0,NA,0,0,0,0,0,0,0,0,"https://fbref.com/en/players/ace50e9f/Estanis"
2025,"Bologna","Serie A","Giovanni Fabbian","ITA","MF","22-133",2003,11.4,10,6,1,3,6,7,13,53.8,6,7,2,5,2,12,4,0,"https://fbref.com/en/players/f97f9188/Giovanni-Fabbian"
2025,"Bologna","Serie A","Lewis Ferguson","SCO","MF","25-276",1999,10.9,24,13,4,14,6,9,16,56.3,7,9,2,7,5,29,9,0,"https://fbref.com/en/players/ee64a822/Lewis-Ferguson"
2025,"Bologna","Serie A","Remo Freuler","SUI","MF","33-042",1992,35.6,79,40,28,40,11,33,79,41.8,46,38,4,34,38,117,57,1,"https://fbref.com/en/players/98d2c2c4/Remo-Freuler"
2025,"Bologna","Serie A","Emil Holm","SWE","DF","25-014",2000,12.6,34,21,17,14,3,20,31,64.5,11,19,4,15,10,44,51,1,"https://fbref.com/en/players/c2357b65/Emil-Holm"
2025,"Bologna","Serie A","Samuel Iling-Junior","ENG","FW,MF","21-235",2003,1.3,3,2,1,1,1,0,1,0,1,1,0,1,2,5,2,0,"https://fbref.com/en/players/ba492306/Samuel-Iling-Junior"
2025,"Bologna","Serie A","Jesper Karlsson","SWE","FW","26-306",1998,3.3,1,0,0,0,1,0,2,0,2,4,0,4,0,1,3,0,"https://fbref.com/en/players/7952d0c2/Jesper-Karlsson"
2025,"Bologna","Serie A","Jhon Lucumí","COL","DF","26-335",1998,29,53,30,23,29,1,29,41,70.7,12,32,14,18,26,79,88,7,"https://fbref.com/en/players/80490d7f/Jhon-Lucumi"
2025,"Bologna","Serie A","Charalambos Lykogiannis","GRE","DF","31-217",1993,11.6,23,14,14,8,1,10,20,50,10,10,5,5,11,34,41,1,"https://fbref.com/en/players/5efc5389/Charalambos-Lykogiannis"
2025,"Bologna","Serie A","Juan Miranda","ESP","DF","25-128",2000,25.3,32,18,11,14,7,14,33,42.4,19,21,3,18,23,55,50,1,"https://fbref.com/en/players/ead61f73/Juan-Miranda"
2025,"Bologna","Serie A","Nikola Moro","CRO","MF","27-076",1998,13.4,35,27,7,21,7,22,33,66.7,11,18,7,11,13,48,18,0,"https://fbref.com/en/players/ff579c7e/Nikola-Moro"
2025,"Bologna","Serie A","Dan Ndoye","SUI","FW","24-214",2000,23.8,26,19,8,8,10,16,28,57.1,12,23,0,23,9,35,4,0,"https://fbref.com/en/players/8e697a8f/Dan-Ndoye"
2025,"Bologna","Serie A","Jens Odgaard","DEN","MF,FW","26-057",1999,21.7,20,14,3,12,5,6,21,28.6,15,19,2,17,9,29,12,1,"https://fbref.com/en/players/75374ee7/Jens-Odgaard"
2025,"Bologna","Serie A","Riccardo Orsolini","ITA","FW","28-123",1997,20.9,16,13,6,6,4,5,11,45.5,6,26,0,26,8,24,10,1,"https://fbref.com/en/players/e14ec482/Riccardo-Orsolini"
2025,"Bologna","Serie A","Tommaso Pobega","ITA","MF","25-316",1999,13.1,33,19,12,15,6,22,30,73.3,8,16,4,12,14,47,16,0,"https://fbref.com/en/players/55a1cac2/Tommaso-Pobega"
2025,"Bologna","Serie A","Stefan Posch","AUT","DF","28-013",1997,7.9,26,15,12,9,5,15,25,60,10,19,4,15,5,31,22,0,"https://fbref.com/en/players/7f609bfc/Stefan-Posch"
2025,"Bologna","Serie A","Federico Ravaglia","ITA","GK","25-197",1999,11.7,0,0,0,0,0,0,0,NA,0,0,0,0,0,0,9,0,"https://fbref.com/en/players/6662d731/Federico-Ravaglia"
2025,"Bologna","Serie A","Łukasz Skorupski","POL","GK","34-022",1991,26.3,1,0,1,0,0,1,3,33.3,2,0,0,0,0,1,13,2,"https://fbref.com/en/players/ab4449d6/Lukasz-Skorupski"
2025,"Bologna","Serie A","Kacper Urbanski","POL","MF","20-262",2004,2.7,5,2,4,0,1,4,6,66.7,2,5,1,4,2,7,5,0,"https://fbref.com/en/players/2d9d9e42/Kacper-Urbanski"
2025,"Bournemouth","Premier League","Max Aarons","ENG","DF","25-143",2000,1,2,2,1,1,0,1,1,100,0,3,1,2,1,3,0,0,"https://fbref.com/en/players/774cf58b/Max-Aarons"
2025,"Bournemouth","Premier League","Tyler Adams","USA","MF","26-102",1999,21.8,83,50,26,49,8,39,72,54.2,33,33,10,23,32,115,42,0,"https://fbref.com/en/players/2b09d998/Tyler-Adams"
2025,"Bournemouth","Premier League","Julian Araujo","MEX","DF","23-287",2001,5.5,10,5,4,6,0,5,12,41.7,7,3,0,3,6,16,18,0,"https://fbref.com/en/players/8f4541c2/Julian-Araujo"
2025,"Bournemouth","Premier League","Kepa Arrizabalaga","ESP","GK","30-236",1994,31,1,0,1,0,0,0,2,0,2,2,0,2,0,1,15,3,"https://fbref.com/en/players/28d596a0/Kepa-Arrizabalaga"
2025,"Bournemouth","Premier League","Philip Billing","DEN","MF","28-350",1996,2,14,5,7,6,1,3,4,75,1,3,0,3,5,19,2,0,"https://fbref.com/en/players/d328a254/Philip-Billing"
2025,"Bournemouth","Premier League","David Brooks","WAL","FW,MF","27-323",1997,10.7,14,6,2,8,4,2,16,12.5,14,18,2,16,5,19,9,1,"https://fbref.com/en/players/dc4cae05/David-Brooks"
2025,"Bournemouth","Premier League","Ryan Christie","SCO","MF","30-094",1995,23.5,54,33,19,27,8,27,64,42.2,37,44,11,33,30,84,51,3,"https://fbref.com/en/players/26ce2263/Ryan-Christie"
2025,"Bournemouth","Premier League","Lewis Cook","ENG","MF,DF","28-113",1997,33.1,81,42,41,36,4,37,67,55.2,30,30,11,19,41,122,70,0,"https://fbref.com/en/players/2afc7272/Lewis-Cook"
2025,"Bournemouth","Premier League","Evanilson","BRA","FW","25-233",1999,25.8,16,10,6,5,5,8,12,66.7,4,11,2,9,1,17,21,0,"https://fbref.com/en/players/6f3cc2fe/Evanilson"
2025,"Bournemouth","Premier League","James Hill","ENG","DF","23-137",2002,5,15,8,6,6,3,3,11,27.3,8,5,0,5,9,24,31,0,"https://fbref.com/en/players/69942fb3/James-Hill"
2025,"Bournemouth","Premier League","Dean Huijsen","ESP","DF","20-043",2005,27,36,26,19,16,1,18,29,62.1,11,40,29,11,51,87,198,4,"https://fbref.com/en/players/87278bce/Dean-Huijsen"
2025,"Bournemouth","Premier League","Daniel Jebbison","ENG","FW","21-287",2003,1.3,5,3,3,2,0,4,6,66.7,2,2,1,1,1,6,1,0,"https://fbref.com/en/players/03edb878/Daniel-Jebbison"
2025,"Bournemouth","Premier League","Milos Kerkez","HUN","DF","21-201",2003,37.1,52,26,25,20,7,24,38,63.2,14,38,11,27,45,97,106,4,"https://fbref.com/en/players/0ad53bdc/Milos-Kerkez"
2025,"Bournemouth","Premier League","Justin Kluivert","NED","MF","26-022",1999,26,23,11,4,11,8,4,22,18.2,18,24,0,24,14,37,24,1,"https://fbref.com/en/players/4c3a6744/Justin-Kluivert"
2025,"Bournemouth","Premier League","Neto","BRA","GK","35-312",1989,2,0,0,0,0,0,0,0,NA,0,0,0,0,0,0,1,1,"https://fbref.com/en/players/a9dc785c/Neto"
2025,"Bournemouth","Premier League","Dango Ouattara","BFA","FW","23-105",2002,22.3,35,26,14,11,10,17,41,41.5,24,36,10,26,11,46,51,0,"https://fbref.com/en/players/2f9e4435/Dango-Ouattara"
2025,"Bournemouth","Premier League","Remy Rees-Dottin","ENG","FW","19-082",2006,0,0,0,0,0,0,0,0,NA,0,0,0,0,0,0,0,0,"https://fbref.com/en/players/1db75ccb/Remy-Rees-Dottin"
2025,"Bournemouth","Premier League","Alex Scott","ENG","MF","21-279",2003,8.4,27,14,11,8,8,19,42,45.2,23,17,4,13,10,37,15,0,"https://fbref.com/en/players/104d0bb8/Alex-Scott"
2025,"Bournemouth","Premier League","Antoine Semenyo","GHA","FW","25-140",2000,35.6,55,35,17,25,13,16,43,37.2,27,67,9,58,11,66,39,2,"https://fbref.com/en/players/efd2ec23/Antoine-Semenyo"
2025,"Bournemouth","Premier League","Marcos Senesi","ARG","DF","28-017",1997,12.3,39,21,23,14,2,14,31,45.2,17,16,7,9,14,53,58,0,"https://fbref.com/en/players/35141f4c/Marcos-Senesi"
2025,"Bournemouth","Premier League","Zain Silcott-Duberry","MSR","FW","19-322",2005,0,1,1,0,0,1,1,1,100,0,0,0,0,0,1,0,0,"https://fbref.com/en/players/2f5fa231/Zain-Silcott-Duberry"
2025,"Bournemouth","Premier League","Luis Sinisterra","COL","FW,MF","25-344",1999,2.6,7,2,3,2,2,0,4,0,4,3,0,3,1,8,8,0,"https://fbref.com/en/players/8e16dd48/Luis-Sinisterra"
2025,"Bournemouth","Premier League","Adam Smith","ENG","DF","34-028",1991,17.7,24,12,11,7,6,14,27,51.9,13,13,5,8,15,39,49,1,"https://fbref.com/en/players/20b104bc/Adam-Smith"
2025,"Bournemouth","Premier League","Julio Soler","ARG","DF,FW","20-100",2005,0.1,1,1,1,0,0,1,1,100,0,1,0,1,0,1,0,0,"https://fbref.com/en/players/98c8559a/Julio-Soler"
2025,"Bournemouth","Premier League","Marcus Tavernier","ENG","FW,MF","26-066",1999,21.5,43,24,15,19,9,10,27,37,17,16,3,13,5,48,11,0,"https://fbref.com/en/players/5c0da4a4/Marcus-Tavernier"
2025,"Bournemouth","Premier League","Mark Travers","IRL","GK","26-009",1999,5,0,0,0,0,0,0,0,NA,0,0,0,0,0,0,5,0,"https://fbref.com/en/players/fe558029/Mark-Travers"
2025,"Bournemouth","Premier League","Enes Ünal","TUR","FW,MF","28-017",1997,3.8,1,0,0,0,1,0,3,0,3,1,0,1,0,1,6,0,"https://fbref.com/en/players/f8eca1b6/Enes-Unal"
2025,"Bournemouth","Premier League","Ben Winterburn","ENG","MF,FW","20-265",2004,0.3,0,0,0,0,0,0,1,0,1,0,0,0,2,2,0,0,"https://fbref.com/en/players/ba31eee2/Ben-Winterburn"
2025,"Bournemouth","Premier League","Illia Zabarnyi","UKR","DF","22-268",2002,34.5,52,36,31,20,1,34,50,68,16,33,20,13,41,93,182,2,"https://fbref.com/en/players/88968486/Illia-Zabarnyi"
2025,"Brentford","Premier League","Kristoffer Ajer","NOR","DF","27-040",1998,16,26,18,14,11,1,14,27,51.9,13,17,4,13,12,38,50,0,"https://fbref.com/en/players/a8c0acb7/Kristoffer-Ajer"
2025,"Brentford","Premier League","Fabio Carvalho","POR","FW,MF","22-270",2002,5.1,13,9,4,4,5,6,13,46.2,7,6,1,5,3,16,2,0,"https://fbref.com/en/players/966e28d0/Fabio-Carvalho"
2025,"Brentford","Premier League","Nathan Collins","IRL","DF","24-027",2001,38,40,24,23,12,5,22,36,61.1,14,77,57,20,34,74,226,3,"https://fbref.com/en/players/a8c19eb8/Nathan-Collins"
2025,"Brentford","Premier League","Mikkel Damsgaard","DEN","MF,FW","24-328",2000,32.3,83,44,27,29,27,31,81,38.3,50,40,3,37,27,110,31,2,"https://fbref.com/en/players/215f3907/Mikkel-Damsgaard"
2025,"Brentford","Premier League","Sepp van den Berg","NED","DF","23-158",2001,28.7,39,24,25,10,4,19,29,65.5,10,52,38,14,21,60,134,3,"https://fbref.com/en/players/7bf9400b/Sepp-van-den-Berg"
2025,"Brentford","Premier League","Yunus Emre Konak","TUR","FW,MF","19-137",2006,0.5,4,4,0,4,0,1,2,50,1,2,0,2,0,4,0,0,"https://fbref.com/en/players/e02b5b36/Yunus-Emre-Konak"
2025,"Brentford","Premier League","Mark Flekken","NED","GK","31-348",1993,36.4,4,4,4,0,0,3,9,33.3,6,2,0,2,0,4,26,4,"https://fbref.com/en/players/a92ab7be/Mark-Flekken"
2025,"Brentford","Premier League","Rico Henry","ENG","DF","27-323",1997,1.1,2,2,1,0,1,0,4,0,4,4,1,3,1,3,2,0,"https://fbref.com/en/players/8a3c1dc7/Rico-Henry"
2025,"Brentford","Premier League","Vitaly Janelt","GER","MF","27-017",1998,25,38,22,14,13,11,21,36,58.3,15,33,9,24,27,65,53,1,"https://fbref.com/en/players/8449d35e/Vitaly-Janelt"
2025,"Brentford","Premier League","Mathias Jensen","DEN","MF","29-146",1996,9.6,14,10,6,6,2,8,16,50,8,15,4,11,8,22,13,2,"https://fbref.com/en/players/0f134faf/Mathias-Jensen"
2025,"Brentford","Premier League","Kim Jisoo","KOR","DF","20-154",2004,0.3,0,0,0,0,0,0,0,NA,0,0,0,0,0,0,2,0,"https://fbref.com/en/players/f4065d9e/Kim-Jisoo"
2025,"Brentford","Premier League","Michael Kayode","ITA","DF","20-321",2004,5.9,17,11,12,5,0,9,13,69.2,4,3,0,3,7,24,19,0,"https://fbref.com/en/players/e19660a8/Michael-Kayode"
2025,"Brentford","Premier League","Keane Lewis-Potter","ENG","DF,FW","24-094",2001,34.4,49,27,26,16,7,31,50,62,19,28,10,18,21,70,76,3,"https://fbref.com/en/players/41f08ac8/Keane-Lewis-Potter"
2025,"Brentford","Premier League","Edmond-Paris Maghoma","ENG","MF,FW","24-019",2001,1.3,2,1,0,2,0,1,3,33.3,2,2,2,0,1,3,2,0,"https://fbref.com/en/players/8a3ddcd2/Edmond-Paris-Maghoma"
2025,"Brentford","Premier League","Bryan Mbeumo","CMR","FW","25-293",1999,37.9,49,31,18,15,16,21,35,60,14,26,3,23,14,63,55,1,"https://fbref.com/en/players/6afaebf2/Bryan-Mbeumo"
2025,"Brentford","Premier League","Ben Mee","ENG","DF","35-248",1989,2,2,2,0,2,0,1,1,100,0,3,3,0,4,6,7,0,"https://fbref.com/en/players/8df7a2fb/Ben-Mee"
2025,"Brentford","Premier League","Jayden Meghoma","ENG","DF","18-333",2006,0.1,0,0,0,0,0,0,0,NA,0,0,0,0,0,0,0,0,"https://fbref.com/en/players/07382f6c/Jayden-Meghoma"
2025,"Brentford","Premier League","Gustavo Nunes","BRA","FW,MF","19-188",2005,0.1,3,2,2,0,1,2,2,100,0,0,0,0,0,3,2,0,"https://fbref.com/en/players/e504780f/Gustavo-Nunes"
2025,"Brentford","Premier League","Christian Nørgaard","DEN","MF","31-078",1994,31.3,79,49,37,35,7,48,81,59.3,33,52,20,32,49,128,70,1,"https://fbref.com/en/players/df0a4c90/Christian-Norgaard"
2025,"Brentford","Premier League","Frank Onyeka","NGA","MF","27-146",1998,0.3,0,0,0,0,0,0,0,NA,0,0,0,0,0,0,0,0,"https://fbref.com/en/players/2944f86f/Frank-Onyeka"
2025,"Brentford","Premier League","Ethan Pinnock","JAM","DF","31-363",1993,21.3,35,19,15,16,4,13,24,54.2,11,29,18,11,24,59,142,4,"https://fbref.com/en/players/e541326e/Ethan-Pinnock"
2025,"Brentford","Premier League","Hákon Rafn Valdimarsson","ISL","GK","23-226",2001,1.6,0,0,0,0,0,0,0,NA,0,0,0,0,0,0,2,0,"https://fbref.com/en/players/57a34cf4/Hakon-Rafn-Valdimarsson"
2025,"Brentford","Premier League","Mads Roerslev","DEN","DF","25-337",1999,12.2,18,8,14,3,1,11,28,39.3,17,12,5,7,4,22,35,0,"https://fbref.com/en/players/57c94db2/Mads-Roerslev"
2025,"Brentford","Premier League","Kevin Schade","GER","FW","23-181",2001,25.5,39,25,17,10,12,13,23,56.5,10,19,4,15,5,44,34,0,"https://fbref.com/en/players/52afb588/Kevin-Schade"
2025,"Brentford","Premier League","Thiago","BRA","FW,MF","23-335",2001,1.9,5,3,2,1,2,0,1,0,1,3,0,3,2,7,3,1,"https://fbref.com/en/players/dc45ac24/Thiago"
2025,"Brentford","Premier League","Ryan Trevitt","ENG","MF","22-076",2003,0,1,1,1,0,0,0,0,NA,0,0,0,0,0,1,0,0,"https://fbref.com/en/players/732327ae/Ryan-Trevitt"
2025,"Brentford","Premier League","Yoane Wissa","COD","FW","28-266",1996,32.4,22,12,6,8,8,11,27,40.7,16,29,8,21,8,30,21,3,"https://fbref.com/en/players/2500cef9/Yoane-Wissa"
2025,"Brentford","Premier League","Yehor Yarmoliuk","UKR","MF","21-087",2004,16.1,49,28,21,21,7,28,55,50.9,27,26,9,17,13,62,33,0,"https://fbref.com/en/players/907a5d7c/Yehor-Yarmoliuk"
2025,"Brest","Ligue 1","Ludovic Ajorque","FRA","FW","31-091",1994,27.7,26,19,3,12,11,10,32,31.3,22,20,5,15,6,32,26,0,"https://fbref.com/en/players/462475ed/Ludovic-Ajorque"
2025,"Brest","Ligue 1","Jordan Amavi","FRA","DF","31-079",1994,8.8,24,17,10,11,3,15,21,71.4,6,10,2,8,7,31,18,0,"https://fbref.com/en/players/22721b88/Jordan-Amavi"
2025,"Brest","Ligue 1","Marco Bizot","NED","GK","34-078",1991,32,2,1,2,0,0,1,2,50,1,0,0,0,0,2,33,0,"https://fbref.com/en/players/3d214e5f/Marco-Bizot"
2025,"Brest","Ligue 1","Justin Bourgault","FRA","DF","19-255",2005,1.4,2,1,1,1,0,0,0,NA,0,0,0,0,0,2,1,0,"https://fbref.com/en/players/2db7975a/Justin-Bourgault"
2025,"Brest","Ligue 1","Mahdi Camara","FRA","MF,FW","26-331",1998,29.5,71,40,16,38,17,24,46,52.2,22,40,5,35,33,104,29,0,"https://fbref.com/en/players/8577e60a/Mahdi-Camara"
2025,"Brest","Ligue 1","Axel Camblan","FRA","MF,FW","21-270",2003,0.3,1,1,0,0,1,1,2,50,1,1,0,1,0,1,0,0,"https://fbref.com/en/players/9f4a940f/Axel-Camblan"
2025,"Brest","Ligue 1","Brendan Chardonnet","FRA","DF","30-156",1994,26.8,45,33,28,14,3,25,40,62.5,15,45,28,17,29,74,169,2,"https://fbref.com/en/players/16aa7d4c/Brendan-Chardonnet"
2025,"Brest","Ligue 1","Grégoire Coudert","FRA","GK","26-054",1999,2,0,0,0,0,0,0,0,NA,0,0,0,0,0,0,1,0,"https://fbref.com/en/players/ca95200f/Gregoire-Coudert"
2025,"Brest","Ligue 1","Soumaïla Coulibaly","FRA","DF","21-225",2003,4.9,4,2,2,2,0,1,1,100,0,7,2,5,5,9,26,0,"https://fbref.com/en/players/9dff291c/Soumaila-Coulibaly"
2025,"Brest","Ligue 1","Romain Del Castillo","FRA","FW","29-059",1996,14,31,22,9,13,9,19,32,59.4,13,16,0,16,6,37,5,0,"https://fbref.com/en/players/0be95d34/Romain-Del-Castillo"
2025,"Brest","Ligue 1","Sérigné Diop","SEN","FW","20-015",2005,0,1,0,0,1,0,0,0,NA,0,1,0,1,0,1,0,0,"https://fbref.com/en/players/21ab03c8/Serigne-Diop"
2025,"Brest","Ligue 1","Kamory Doumbia","MLI","MF,FW","22-098",2003,14.7,41,29,17,17,7,14,31,45.2,17,17,1,16,28,69,13,1,"https://fbref.com/en/players/9226aa22/Kamory-Doumbia"
2025,"Brest","Ligue 1","Romain Faivre","FRA","MF,FW","26-317",1998,10,13,10,4,5,4,5,10,50,5,8,0,8,4,17,3,1,"https://fbref.com/en/players/745ca0a3/Romain-Faivre"
2025,"Brest","Ligue 1","Edimilson Fernandes","SUI","MF,DF","29-042",1996,12.3,9,7,3,6,0,7,13,53.8,6,14,6,8,20,29,38,1,"https://fbref.com/en/players/3bb625ac/Edimilson-Fernandes"
2025,"Brest","Ligue 1","Massadio Haïdara","MLI","DF","32-176",1992,18.6,27,16,16,9,2,13,29,44.8,16,18,2,16,26,53,73,0,"https://fbref.com/en/players/5167c97e/Massadio-Haidara"
2025,"Brest","Ligue 1","Kenny Lala","MAD","DF","33-236",1991,29.8,66,42,36,23,7,38,57,66.7,19,25,9,16,25,91,75,2,"https://fbref.com/en/players/770d7eb8/Kenny-Lala"
2025,"Brest","Ligue 1","Julien Le Cardinal","FRA","DF","27-297",1997,15.3,27,15,16,8,3,11,16,68.8,5,18,14,4,33,60,75,0,"https://fbref.com/en/players/547a72ad/Julien-Le-Cardinal"
2025,"Brest","Ligue 1","Jérémy Le Douaron","FRA","FW","27-036",1998,1.1,1,0,0,0,1,0,1,0,1,1,0,1,0,1,0,0,"https://fbref.com/en/players/88c4d190/Jeremy-Le-Douaron"
2025,"Brest","Ligue 1","Pierre Lees-Melou","FRA","MF","32-002",1993,17,48,33,20,19,9,25,54,46.3,29,19,3,16,12,60,23,0,"https://fbref.com/en/players/f5044e54/Pierre-Lees-Melou"
2025,"Brest","Ligue 1","Bradley Locko","FRA","DF","23-021",2002,1.1,2,2,1,1,0,1,1,100,0,3,2,1,1,3,3,0,"https://fbref.com/en/players/40221fa7/Bradley-Locko"
2025,"Brest","Ligue 1","Hugo Magnetti","FRA","MF","26-362",1998,25.8,52,32,21,27,4,23,51,45.1,28,20,3,17,18,70,37,0,"https://fbref.com/en/players/d4d35152/Hugo-Magnetti"
2025,"Brest","Ligue 1","Hamidou Makalou","MLI","FW,MF","18-316",2006,0.4,0,0,0,0,0,0,0,NA,0,0,0,0,0,0,0,0,"https://fbref.com/en/players/8fe2fb2a/Hamidou-Makalou"
2025,"Brest","Ligue 1","Hianga Mananga Mbock","FRA","MF","25-150",1999,0.2,0,0,0,0,0,0,0,NA,0,0,0,0,1,1,0,0,"https://fbref.com/en/players/0f86995c/Hianga-Mananga-Mbock"
2025,"Brest","Ligue 1","Jonas Martin","FRA","MF","35-048",1990,5.5,13,7,10,2,1,6,11,54.5,5,4,1,3,8,21,12,1,"https://fbref.com/en/players/468fdbad/Jonas-Martin"
2025,"Brest","Ligue 1","Abdoulaye Niakhate Ndiaye","SEN","DF","23-047",2002,19,49,33,36,12,1,25,37,67.6,12,29,17,12,11,60,144,3,"https://fbref.com/en/players/b8cd2ae4/Abdoulaye-Niakhate-Ndiaye"
2025,"Brest","Ligue 1","Mathias Pereira Lage","POR","FW,MF","28-178",1996,17.5,37,24,16,13,8,18,39,46.2,21,17,2,15,20,57,20,2,"https://fbref.com/en/players/8846a40f/Mathias-Pereira-Lage"
2025,"Brest","Ligue 1","Ibrahim Salah","MAR","FW","23-270",2001,4,4,2,1,1,2,1,6,16.7,5,2,0,2,2,6,0,0,"https://fbref.com/en/players/cad3fd4d/Ibrahim-Salah"
2025,"Brest","Ligue 1","Mama Samba Baldé","GNB","FW","29-202",1995,12.8,13,9,4,4,5,3,14,21.4,11,8,0,8,6,19,14,0,"https://fbref.com/en/players/fb14aa28/Mama-Samba-Balde"
2025,"Brest","Ligue 1","Abdallah Sima","SEN","FW,MF","23-344",2001,13.8,15,11,2,5,8,4,11,36.4,7,9,1,8,1,16,9,0,"https://fbref.com/en/players/fdbde523/Abdallah-Sima"
2025,"Brest","Ligue 1","Luc Zogbé","CIV","DF","20-064",2005,7.1,32,18,17,11,4,18,26,69.2,8,11,2,9,14,46,22,1,"https://fbref.com/en/players/3725b44f/Luc-Zogbe"
2025,"Brighton","Premier League","Simon Adingra","CIV","FW,MF","23-146",2002,12.2,23,14,10,8,5,10,26,38.5,16,12,0,12,8,31,6,2,"https://fbref.com/en/players/4dcec659/Simon-Adingra"
2025,"Brighton","Premier League","Yasin Ayari","SWE","MF","21-233",2003,21.8,59,32,15,31,13,26,56,46.4,30,24,6,18,20,79,26,0,"https://fbref.com/en/players/f173303a/Yasin-Ayari"
2025,"Brighton","Premier League","Carlos Baleba","CMR","MF","21-144",2004,29.6,79,46,26,37,16,48,80,60,32,47,11,36,46,125,44,1,"https://fbref.com/en/players/a1390d2f/Carlos-Baleba"
2025,"Brighton","Premier League","Eiran Cashin","IRL","DF","23-199",2001,0.2,0,0,0,0,0,0,1,0,1,0,0,0,0,0,2,0,"https://fbref.com/en/players/f557c3b8/Eiran-Cashin"
2025,"Brighton","Premier League","Lewis Dunk","ENG","DF","33-187",1991,23.1,17,10,8,7,2,11,19,57.9,8,28,18,10,13,30,79,2,"https://fbref.com/en/players/282f75f3/Lewis-Dunk"
2025,"Brighton","Premier League","Julio Enciso","PAR","MF,FW","21-124",2004,3.3,0,0,0,0,0,0,2,0,2,2,0,2,0,0,1,0,"https://fbref.com/en/players/9cfbad36/Julio-Enciso"
2025,"Brighton","Premier League","Pervis Estupiñán","ECU","DF","27-126",1998,26.7,65,43,33,25,7,34,51,66.7,17,20,5,15,37,102,65,2,"https://fbref.com/en/players/d38fdf53/Pervis-Estupinan"
2025,"Brighton","Premier League","Evan Ferguson","IRL","FW","20-220",2004,2.7,4,3,0,3,1,2,5,40,3,3,1,2,0,4,4,0,"https://fbref.com/en/players/4596da74/Evan-Ferguson"
2025,"Brighton","Premier League","Billy Gilmour","SCO","MF","23-350",2001,1.1,3,3,2,1,0,3,4,75,1,1,0,1,0,3,1,0,"https://fbref.com/en/players/df10e27c/Billy-Gilmour"
2025,"Brighton","Premier League","Diego Gómez","PAR","MF","22-061",2003,5.7,21,13,11,8,2,12,22,54.5,10,13,0,13,8,29,10,1,"https://fbref.com/en/players/916728da/Diego-Gomez"
2025,"Brighton","Premier League","Brajan Gruda","GER","MF,FW","20-361",2004,7.6,16,8,6,6,4,7,14,50,7,8,0,8,2,18,5,1,"https://fbref.com/en/players/ae9b998d/Brajan-Gruda"
2025,"Brighton","Premier League","Jan Paul van Hecke","NED","DF","24-353",2000,32.9,45,29,24,19,2,23,41,56.1,18,37,22,15,24,69,142,2,"https://fbref.com/en/players/4fd08daa/Jan-Paul-van-Hecke"
2025,"Brighton","Premier League","Jack Hinshelwood","ENG","MF,DF","20-046",2005,20.5,27,19,8,10,9,11,27,40.7,16,10,3,7,16,43,37,1,"https://fbref.com/en/players/e98211e7/Jack-Hinshelwood"
2025,"Brighton","Premier League","Harry Howell","ENG","FW","16-240",2008,0.1,1,1,1,0,0,1,2,50,1,1,0,1,0,1,0,0,"https://fbref.com/en/players/d8a7e52c/Harry-Howell"
2025,"Brighton","Premier League","Igor","BRA","DF","27-109",1998,10.7,5,5,2,2,1,4,10,40,6,24,14,10,4,9,39,1,"https://fbref.com/en/players/a4e85758/Igor"
2025,"Brighton","Premier League","João Pedro","BRA","FW,MF","23-243",2001,21.6,16,12,6,6,4,4,11,36.4,7,12,0,12,9,25,12,0,"https://fbref.com/en/players/e8832875/Joao-Pedro"
2025,"Brighton","Premier League","Ferdi Kadioglu","TUR","DF,MF","25-232",1999,4.3,10,6,4,5,1,6,15,40,9,2,2,0,8,18,17,0,"https://fbref.com/en/players/66c52a77/Ferdi-Kadioglu"
2025,"Brighton","Premier League","Tariq Lamptey","GHA","DF","24-239",2000,9.6,17,11,8,9,0,9,25,36,16,15,7,8,7,24,23,1,"https://fbref.com/en/players/f4e433d4/Tariq-Lamptey"
2025,"Brighton","Premier League","Solly March","ENG","FW,MF","30-311",1994,1.9,6,3,2,2,2,5,8,62.5,3,3,0,3,2,8,2,1,"https://fbref.com/en/players/bb5fbd2b/Solly-March"
2025,"Brighton","Premier League","James Milner","ENG","MF","39-143",1986,1.9,5,2,1,3,1,3,3,100,0,4,2,2,2,7,2,1,"https://fbref.com/en/players/2f90f6b8/James-Milner"
2025,"Brighton","Premier League","Yankuba Minteh","GAM","FW,MF","20-309",2004,20.4,48,35,25,13,10,17,45,37.8,28,22,0,22,11,59,31,0,"https://fbref.com/en/players/c3cf087d/Yankuba-Minteh"
2025,"Brighton","Premier League","Kaoru Mitoma","JPN","FW,MF","28-007",1997,28.9,45,27,15,14,16,19,49,38.8,30,48,3,45,14,59,10,0,"https://fbref.com/en/players/74618572/Kaoru-Mitoma"
2025,"Brighton","Premier League","Jakub Moder","POL","MF","26-050",1999,0.1,1,0,1,0,0,0,2,0,2,0,0,0,0,1,3,0,"https://fbref.com/en/players/f230bc30/Jakub-Moder"
2025,"Brighton","Premier League","Matt O'Riley","DEN","MF","24-187",2000,10.4,16,9,4,8,4,4,13,30.8,9,7,3,4,13,29,9,1,"https://fbref.com/en/players/fb495bb8/Matt-ORiley"
2025,"Brighton","Premier League","Georginio Rutter","FRA","MF,FW","23-037",2002,18.4,39,15,13,18,8,14,36,38.9,22,20,3,17,10,49,13,2,"https://fbref.com/en/players/c64c01fc/Georginio-Rutter"
2025,"Brighton","Premier League","Jeremy Sarmiento","ECU","MF","22-345",2002,0.1,0,0,0,0,0,0,0,NA,0,0,0,0,0,0,0,0,"https://fbref.com/en/players/ac0d576d/Jeremy-Sarmiento"
2025,"Brighton","Premier League","Jason Steele","ENG","GK","34-282",1990,2,0,0,0,0,0,0,0,NA,0,0,0,0,0,0,1,0,"https://fbref.com/en/players/28300a16/Jason-Steele"
2025,"Brighton","Premier League","Joël Veltman","NED","DF","33-132",1992,18.9,43,29,24,16,3,31,52,59.6,21,22,7,15,19,62,66,0,"https://fbref.com/en/players/dad4b285/Joel-Veltman"
2025,"Brighton","Premier League","Bart Verbruggen","NED","GK","22-282",2002,36,0,0,0,0,0,0,3,0,3,1,0,1,0,0,29,5,"https://fbref.com/en/players/cf134113/Bart-Verbruggen"
2025,"Brighton","Premier League","Adam Webster","ENG","DF","30-143",1995,9.9,10,6,5,4,1,6,14,42.9,8,16,9,7,20,30,41,2,"https://fbref.com/en/players/c40b6180/Adam-Webster"
2025,"Brighton","Premier League","Danny Welbeck","ENG","FW","34-182",1990,23.5,26,16,6,15,5,8,20,40,12,19,4,15,5,31,14,0,"https://fbref.com/en/players/ce5143da/Danny-Welbeck"
2025,"Brighton","Premier League","Mats Wieffer","NED","DF,MF","25-192",1999,11.3,58,34,27,27,4,32,47,68.1,15,18,2,16,17,75,28,3,"https://fbref.com/en/players/4876c9ab/Mats-Wieffer"
2025,"Cagliari","Serie A","Tommaso Augello","ITA","DF","30-270",1994,30.1,49,28,28,17,4,30,43,69.8,13,23,8,15,16,65,109,2,"https://fbref.com/en/players/3cd3b384/Tommaso-Augello"
2025,"Cagliari","Serie A","Paulo Azzi","BRA","DF","30-316",1994,4.7,11,9,3,6,2,5,9,55.6,4,5,2,3,5,16,11,0,"https://fbref.com/en/players/967ac202/Paulo-Azzi"
2025,"Cagliari","Serie A","Elia Caprile","ITA","GK","23-275",2001,18,1,0,1,0,0,0,2,0,2,0,0,0,0,1,9,1,"https://fbref.com/en/players/97d7afbd/Elia-Caprile"
2025,"Cagliari","Serie A","Giuseppe Ciocci","ITA","GK","23-123",2002,0.1,0,0,0,0,0,0,0,NA,0,0,0,0,0,0,0,0,"https://fbref.com/en/players/d6416327/Giuseppe-Ciocci"
2025,"Cagliari","Serie A","Florinel Coman","ROU","FW,MF","27-047",1998,2.9,5,3,3,1,1,2,2,100,0,2,0,2,1,6,3,0,"https://fbref.com/en/players/a9440c25/Florinel-Coman"
2025,"Cagliari","Serie A","Alessandro Deiola","ITA","MF","29-299",1995,15.9,31,20,11,17,3,10,32,31.3,22,26,12,14,13,44,38,0,"https://fbref.com/en/players/7f267d66/Alessandro-Deiola"
2025,"Cagliari","Serie A","Mattia Felici","ITA","MF,FW","24-040",2001,10.3,17,12,8,7,2,4,11,36.4,7,10,0,10,7,24,7,1,"https://fbref.com/en/players/38aa2612/Mattia-Felici"
2025,"Cagliari","Serie A","Gianluca Gaetano","ITA","MF,FW","25-022",2000,11.2,11,8,4,6,1,5,15,33.3,10,8,0,8,6,17,8,0,"https://fbref.com/en/players/3b387cc7/Gianluca-Gaetano"
2025,"Cagliari","Serie A","Gianluca Lapadula","PER","FW,MF","35-109",1990,3.4,2,0,1,0,1,0,1,0,1,0,0,0,0,2,1,0,"https://fbref.com/en/players/2ead2809/Gianluca-Lapadula"
2025,"Cagliari","Serie A","José Luis Palomino","ARG","DF","35-142",1990,12,27,15,16,9,2,15,21,71.4,6,21,11,10,22,49,46,0,"https://fbref.com/en/players/921f6058/Jose-Luis-Palomino"
2025,"Cagliari","Serie A","Sebastiano Luperto","ITA","DF","28-263",1996,36,48,27,31,16,1,18,28,64.3,10,30,15,15,33,81,161,1,"https://fbref.com/en/players/997fff07/Sebastiano-Luperto"
2025,"Cagliari","Serie A","Zito Luvumbo","ANG","FW,MF","23-079",2002,17.8,10,6,4,3,3,6,19,31.6,13,5,0,5,4,14,4,0,"https://fbref.com/en/players/b09e0873/Zito-Luvumbo"
2025,"Cagliari","Serie A","Antoine Makoumbou","CGO","MF","26-313",1998,23.9,42,23,28,11,3,19,25,76,6,26,5,21,17,59,28,0,"https://fbref.com/en/players/f37f3522/Antoine-Makoumbou"
2025,"Cagliari","Serie A","Răzvan Marin","ROU","MF","29-004",1996,15.6,22,13,8,11,3,13,25,52,12,7,0,7,2,24,20,2,"https://fbref.com/en/players/7fac99d4/Razvan-Marin"
2025,"Cagliari","Serie A","Yerry Mina","COL","DF","30-246",1994,28.5,66,32,43,21,2,40,52,76.9,12,59,35,24,37,103,163,3,"https://fbref.com/en/players/6d5701f2/Yerry-Mina"
2025,"Cagliari","Serie A","Kingstone Mutandwa","ZAM","FW,MF","22-142",2003,1.4,0,0,0,0,0,0,0,NA,0,0,0,0,0,0,0,0,"https://fbref.com/en/players/cbe32194/Kingstone-Mutandwa"
2025,"Cagliari","Serie A","Michel Ndary Adopo","FRA","MF","24-312",2000,26.8,55,32,16,31,8,15,29,51.7,14,20,5,15,27,82,25,0,"https://fbref.com/en/players/599d91d0/Michel-Ndary-Adopo"
2025,"Cagliari","Serie A","Adam Obert","SVK","DF","22-277",2002,12,31,18,12,17,2,16,27,59.3,11,19,7,12,23,54,48,2,"https://fbref.com/en/players/aa25ce92/Adam-Obert"
2025,"Cagliari","Serie A","Leonardo Pavoletti","ITA","FW,MF","36-182",1988,4.9,1,0,0,1,0,0,0,NA,0,4,1,3,0,1,3,0,"https://fbref.com/en/players/d37b0350/Leonardo-Pavoletti"
2025,"Cagliari","Serie A","Roberto Piccoli","ITA","FW","24-120",2001,34.7,13,9,2,6,5,3,12,25,9,12,4,8,3,16,31,0,"https://fbref.com/en/players/1cadaf34/Roberto-Piccoli"
2025,"Cagliari","Serie A","Nicola Pintus","ITA","DF","20-002",2005,0,0,0,0,0,0,0,0,NA,0,0,0,0,0,0,2,0,"https://fbref.com/en/players/8d1a4c36/Nicola-Pintus"
2025,"Cagliari","Serie A","Matteo Prati","ITA","MF","21-150",2003,6.3,10,4,2,7,1,3,11,27.3,8,5,2,3,7,17,10,1,"https://fbref.com/en/players/d8363914/Matteo-Prati"
2025,"Cagliari","Serie A","Simone Scuffet","ITA","GK","28-361",1996,13,0,0,0,0,0,0,1,0,1,0,0,0,0,0,8,2,"https://fbref.com/en/players/41bd99ea/Simone-Scuffet"
2025,"Cagliari","Serie A","Alen Sherri","ALB","GK","27-163",1997,6.9,1,0,1,0,0,1,2,50,1,0,0,0,1,2,1,0,"https://fbref.com/en/players/eebf35b6/Alen-Sherri"
2025,"Cagliari","Serie A","Nicolas Viola","ITA","FW,MF","35-227",1989,14.1,14,7,6,7,1,1,10,10,9,5,0,5,3,17,5,0,"https://fbref.com/en/players/45392b06/Nicolas-Viola"
2025,"Cagliari","Serie A","Mateusz Wieteska","POL","DF","28-105",1997,2,1,0,0,1,0,1,1,100,0,3,2,1,7,8,6,0,"https://fbref.com/en/players/3ecc8c5f/Mateusz-Wieteska"
2025,"Cagliari","Serie A","Gabriele Zappa","ITA","DF","25-156",1999,34,40,23,20,17,3,17,34,50,17,42,22,20,23,63,93,1,"https://fbref.com/en/players/ca3db240/Gabriele-Zappa"
2025,"Cagliari","Serie A","Nadir Zortea","ITA","DF,MF","25-342",1999,30.1,30,14,16,12,2,14,37,37.8,23,11,0,11,19,49,47,2,"https://fbref.com/en/players/82598b71/Nadir-Zortea"
2025,"Celta Vigo","La Liga","Joseph Aidoo","GHA","DF","29-240",1995,0,1,0,1,0,0,0,0,NA,0,0,0,0,0,1,0,0,"https://fbref.com/en/players/18abe173/Joseph-Aidoo"
2025,"Celta Vigo","La Liga","Alfon","ESP","FW,MF","26-023",1999,15.2,8,3,3,2,3,4,12,33.3,8,8,0,8,5,13,5,1,"https://fbref.com/en/players/1c772b46/Alfon"
2025,"Celta Vigo","La Liga","Tadeo Allende","ARG","FW","26-096",1999,0,0,0,0,0,0,0,0,NA,0,0,0,0,0,0,0,0,"https://fbref.com/en/players/75a66bed/Tadeo-Allende"
2025,"Celta Vigo","La Liga","Marcos Alonso","ESP","DF","34-150",1990,29.4,35,21,19,13,3,25,44,56.8,19,22,7,15,34,69,126,4,"https://fbref.com/en/players/f4290206/Marcos-Alonso"
2025,"Celta Vigo","La Liga","Hugo Álvarez","ESP","MF,DF","21-329",2003,17.5,26,9,12,10,4,10,19,52.6,9,19,2,17,8,34,29,1,"https://fbref.com/en/players/6f392eb8/Hugo-Alvarez"
2025,"Celta Vigo","La Liga","Iago Aspas","ESP","FW,MF","37-299",1987,19.4,13,8,4,5,4,8,20,40,12,18,1,17,8,21,5,0,"https://fbref.com/en/players/7dcf86f6/Iago-Aspas"
2025,"Celta Vigo","La Liga","Jonathan Bamba","CIV","FW,MF","29-062",1996,9,12,7,4,6,2,5,12,41.7,7,6,0,6,5,17,6,0,"https://fbref.com/en/players/b2bd0f6c/Jonathan-Bamba"
2025,"Celta Vigo","La Liga","Fran Beltrán","ESP","MF","26-113",1999,26.9,50,35,24,21,5,24,56,42.9,32,26,6,20,26,76,34,4,"https://fbref.com/en/players/ed5c5fa3/Fran-Beltran"
2025,"Celta Vigo","La Liga","Sergio Carreira","ESP","MF,DF","24-226",2000,18.4,28,16,16,6,6,14,26,53.8,12,20,2,18,17,45,37,0,"https://fbref.com/en/players/8d6a9c93/Sergio-Carreira"
2025,"Celta Vigo","La Liga","Franco Cervi","ARG","FW,MF","31-001",1994,3,8,3,2,6,0,3,8,37.5,5,4,0,4,8,16,7,0,"https://fbref.com/en/players/5e1028e5/Franco-Cervi"
2025,"Celta Vigo","La Liga","Carlos Dominguez","ESP","DF","24-105",2001,13.1,23,11,14,9,0,15,21,71.4,6,16,11,5,13,36,80,1,"https://fbref.com/en/players/3521abfe/Carlos-Dominguez"
2025,"Celta Vigo","La Liga","Anastasios Douvikas","GRE","FW","25-298",1999,7.8,9,4,2,6,1,3,6,50,3,5,2,3,3,12,6,0,"https://fbref.com/en/players/853ca71c/Anastasios-Douvikas"
2025,"Celta Vigo","La Liga","Pablo Durán","ESP","FW,MF","24-002",2001,15.5,17,9,4,7,6,5,16,31.3,11,12,3,9,8,25,18,0,"https://fbref.com/en/players/6db116ec/Pablo-Duran"
2025,"Celta Vigo","La Liga","Vicente Guaita","ESP","GK","38-137",1987,34,0,0,0,0,0,0,0,NA,0,0,0,0,0,0,21,3,"https://fbref.com/en/players/ab13a5aa/Vicente-Guaita"
2025,"Celta Vigo","La Liga","Borja Iglesias","ESP","FW","32-130",1993,21.7,10,9,2,5,3,4,15,26.7,11,9,2,7,7,17,10,0,"https://fbref.com/en/players/75645f0e/Borja-Iglesias"
2025,"Celta Vigo","La Liga","Luca de la Torre","USA","MF","27-004",1998,0,0,0,0,0,0,0,0,NA,0,0,0,0,0,0,0,0,"https://fbref.com/en/players/e9241b40/Luca-de-la-Torre"
2025,"Celta Vigo","La Liga","Yoel Lago","ESP","DF","21-063",2004,6.5,12,8,8,3,1,7,9,77.8,2,5,4,1,4,16,30,0,"https://fbref.com/en/players/edd4e7a5/Yoel-Lago"
2025,"Celta Vigo","La Liga","Fer López","","FW,MF","",NA,7.5,9,5,1,6,2,2,13,15.4,11,10,0,10,2,11,7,0,"https://fbref.com/en/players/675cacff/Fer-Lopez"
2025,"Celta Vigo","La Liga","Iker Losada","ESP","FW,MF","23-299",2001,4,3,3,0,1,2,1,5,20,4,4,1,3,1,4,8,0,"https://fbref.com/en/players/41521385/Iker-Losada"
2025,"Celta Vigo","La Liga","Javier Manquillo","ESP","DF","31-022",1994,5.7,7,5,4,3,0,2,10,20,8,5,3,2,7,14,14,0,"https://fbref.com/en/players/758dd7f0/Javier-Manquillo"
2025,"Celta Vigo","La Liga","Óscar Mingueza","ESP","MF,DF","26-014",1999,30.3,38,24,21,12,5,26,69,37.7,43,35,5,30,22,60,46,7,"https://fbref.com/en/players/056269d7/Oscar-Mingueza"
2025,"Celta Vigo","La Liga","Ilaix Moriba","GUI","MF","22-128",2003,23.7,68,42,24,30,14,32,57,56.1,25,29,4,25,14,82,33,1,"https://fbref.com/en/players/f4c69aa6/Ilaix-Moriba"
2025,"Celta Vigo","La Liga","Mihailo Ristić","SRB","DF,MF","29-208",1995,4.8,7,7,4,2,1,4,6,66.7,2,1,0,1,2,9,18,0,"https://fbref.com/en/players/ea0aa7e0/Mihailo-Ristic"
2025,"Celta Vigo","La Liga","Damián Rodríguez","ESP","MF","22-071",2003,10.3,14,9,3,10,1,6,16,37.5,10,6,1,5,7,21,13,0,"https://fbref.com/en/players/22371dee/Damian-Rodriguez"
2025,"Celta Vigo","La Liga","Javi Rodríguez","ESP","DF","21-335",2003,27.9,53,38,35,17,1,33,47,70.2,14,29,10,19,33,86,96,2,"https://fbref.com/en/players/08ec5e71/Javi-Rodriguez"
2025,"Celta Vigo","La Liga","Jailson Siqueira","BRA","DF,MF","29-262",1995,6.8,13,11,9,3,1,9,11,81.8,2,6,4,2,9,22,28,1,"https://fbref.com/en/players/b4819112/Jailson-Siqueira"
2025,"Celta Vigo","La Liga","Hugo Sotelo","ESP","MF","21-159",2003,13.9,28,17,8,10,10,13,31,41.9,18,9,1,8,5,33,9,1,"https://fbref.com/en/players/3aa74860/Hugo-Sotelo"
2025,"Celta Vigo","La Liga","Carl Starfelt","SWE","DF","29-360",1995,25.2,40,20,25,14,1,18,27,66.7,9,29,21,8,31,71,129,3,"https://fbref.com/en/players/5cfec13d/Carl-Starfelt"
2025,"Celta Vigo","La Liga","Williot Swedberg","SWE","FW,MF","21-115",2004,15,23,16,9,10,4,13,20,65,7,12,1,11,3,26,10,1,"https://fbref.com/en/players/184fe4b2/Williot-Swedberg"
2025,"Celta Vigo","La Liga","Iván Villar","ESP","GK","27-322",1997,4,0,0,0,0,0,0,0,NA,0,0,0,0,0,0,3,0,"https://fbref.com/en/players/cde52ef5/Ivan-Villar"
2025,"Chelsea","Premier League","Joshua Acheampong","ENG","DF","19-022",2006,1.9,2,1,2,0,0,2,2,100,0,1,0,1,1,3,2,0,"https://fbref.com/en/players/b7e62e1d/Joshua-Acheampong"
2025,"Chelsea","Premier League","Tosin Adarabioyo","ENG","DF","27-245",1997,15.7,17,13,11,6,0,8,12,66.7,4,9,7,2,11,28,80,0,"https://fbref.com/en/players/c81d773d/Tosin-Adarabioyo"
2025,"Chelsea","Premier League","Mathis Amougou","FRA","MF","19-129",2006,0.1,0,0,0,0,0,0,0,NA,0,0,0,0,0,0,0,0,"https://fbref.com/en/players/f93cca97/Mathis-Amougou"
2025,"Chelsea","Premier League","Benoît Badiashile","FRA","DF","24-062",2001,3.7,9,6,5,4,0,4,5,80,1,2,2,0,6,15,12,2,"https://fbref.com/en/players/06df8256/Benoit-Badiashile"
2025,"Chelsea","Premier League","Moisés Caicedo","ECU","MF,DF","23-206",2001,37.2,114,73,44,54,16,54,86,62.8,32,49,10,39,49,163,60,1,"https://fbref.com/en/players/16264a81/Moises-Caicedo"
2025,"Chelsea","Premier League","Trevoh Chalobah","ENG","DF","25-326",1999,10.1,11,7,5,6,0,7,8,87.5,1,6,3,3,10,21,48,1,"https://fbref.com/en/players/5515376c/Trevoh-Chalobah"
2025,"Chelsea","Premier League","Levi Colwill","ENG","DF","22-090",2003,35,47,34,25,19,3,18,27,66.7,9,37,25,12,33,80,118,4,"https://fbref.com/en/players/700783e7/Levi-Colwill"
2025,"Chelsea","Premier League","Marc Cucurella","ESP","DF","26-309",1998,33.2,67,45,31,31,5,32,61,52.5,29,49,16,33,28,95,95,3,"https://fbref.com/en/players/1daec722/Marc-Cucurella"
2025,"Chelsea","Premier League","Kiernan Dewsbury-Hall","ENG","MF,FW","26-263",1998,2.9,8,5,1,1,6,4,6,66.7,2,2,0,2,2,10,9,1,"https://fbref.com/en/players/5c74c0f5/Kiernan-Dewsbury-Hall"
2025,"Chelsea","Premier League","Axel Disasi","FRA","DF","27-077",1998,4,7,4,5,1,1,6,11,54.5,5,4,1,3,2,9,11,1,"https://fbref.com/en/players/ad82197c/Axel-Disasi"
2025,"Chelsea","Premier League","João Félix","POR","FW,MF","25-198",1999,4.1,8,3,2,5,1,5,9,55.6,4,2,0,2,3,11,2,0,"https://fbref.com/en/players/8aafd64f/Joao-Felix"
2025,"Chelsea","Premier League","Enzo Fernández","ARG","MF","24-130",2001,32.7,65,33,17,30,18,31,84,36.9,53,43,7,36,13,78,23,4,"https://fbref.com/en/players/5ff4ab71/Enzo-Fernandez"
2025,"Chelsea","Premier League","Wesley Fofana","FRA","DF","24-161",2000,13,13,12,6,7,0,6,14,42.9,8,14,9,5,14,27,55,2,"https://fbref.com/en/players/132a82f1/Wesley-Fofana"
2025,"Chelsea","Premier League","Tyrique George","ENG","FW","19-112",2006,2,2,0,2,0,0,2,3,66.7,1,1,0,1,2,4,1,0,"https://fbref.com/en/players/e6f7797e/Tyrique-George"
2025,"Chelsea","Premier League","Marc Guiu","ESP","FW","19-143",2006,0.8,1,1,0,1,0,1,1,100,0,0,0,0,0,1,0,0,"https://fbref.com/en/players/d3d774cc/Marc-Guiu"
2025,"Chelsea","Premier League","Malo Gusto","FRA","DF","22-008",2003,20.7,45,29,27,15,3,25,48,52.1,23,29,8,21,24,69,49,5,"https://fbref.com/en/players/d56b9520/Malo-Gusto"
2025,"Chelsea","Premier League","Nicolas Jackson","SEN","FW","23-341",2001,24.7,22,13,6,7,9,5,10,50,5,15,2,13,3,25,15,0,"https://fbref.com/en/players/9c36ed83/Nicolas-Jackson"
2025,"Chelsea","Premier League","Reece James","ENG","DF,MF","25-170",1999,11.8,10,9,6,3,1,3,9,33.3,6,14,6,8,13,23,23,4,"https://fbref.com/en/players/1265a93a/Reece-James"
2025,"Chelsea","Premier League","Filip Jørgensen","DEN","GK","23-041",2002,6,0,0,0,0,0,0,0,NA,0,0,0,0,0,0,0,3,"https://fbref.com/en/players/0107757e/Filip-Jorgensen"
2025,"Chelsea","Premier League","Roméo Lavia","BEL","MF","21-141",2004,8.9,22,13,5,13,4,10,21,47.6,11,6,0,6,16,38,10,1,"https://fbref.com/en/players/ecad9aa5/Romeo-Lavia"
2025,"Chelsea","Premier League","Noni Madueke","ENG","FW","23-078",2002,22.6,25,18,8,12,5,14,38,36.8,24,17,0,17,10,35,11,0,"https://fbref.com/en/players/bf34eebd/Noni-Madueke"
2025,"Chelsea","Premier League","Shumaira Mheuka","ENG","MF","17-219",2007,0,0,0,0,0,0,0,0,NA,0,0,0,0,0,0,0,0,"https://fbref.com/en/players/43d0b694/Shumaira-Mheuka"
2025,"Chelsea","Premier League","Mykhailo Mudryk","UKR","FW","24-142",2001,1.7,2,2,2,0,0,0,0,NA,0,3,1,2,0,2,1,0,"https://fbref.com/en/players/049a888d/Mykhailo-Mudryk"
2025,"Chelsea","Premier League","Pedro Neto","POR","FW","25-079",2000,25.2,23,9,9,9,5,9,21,42.9,12,14,2,12,9,32,6,0,"https://fbref.com/en/players/7ba2eaa9/Pedro-Neto"
2025,"Chelsea","Premier League","Christopher Nkunku","FRA","FW","27-194",1997,10.2,12,8,3,4,5,6,8,75,2,9,2,7,7,19,10,0,"https://fbref.com/en/players/7c56da38/Christopher-Nkunku"
2025,"Chelsea","Premier League","Cole Palmer","ENG","MF,FW","23-021",2002,35.5,34,20,12,10,12,12,27,44.4,15,16,1,15,11,45,20,1,"https://fbref.com/en/players/dc7f8a28/Cole-Palmer"
2025,"Chelsea","Premier League","Robert Sánchez","ESP","GK","27-190",1997,32,0,0,0,0,0,0,1,0,1,0,0,0,2,2,24,10,"https://fbref.com/en/players/6a713852/Robert-Sanchez"
2025,"Chelsea","Premier League","Jadon Sancho","ENG","FW","25-063",2000,19.6,13,7,3,3,7,5,12,41.7,7,11,0,11,2,15,8,2,"https://fbref.com/en/players/dbf053da/Jadon-Sancho"
2025,"Chelsea","Premier League","Renato Veiga","POR","DF,MF","21-302",2003,2,9,6,6,3,0,4,12,33.3,8,3,1,2,1,10,2,0,"https://fbref.com/en/players/fc8fcbd1/Renato-Veiga"
2025,"Como","Serie A","Oliver Abildgaard","DEN","MF","28-351",1996,0.1,0,0,0,0,0,0,0,NA,0,1,0,1,0,0,0,0,"https://fbref.com/en/players/8f5cdf66/Oliver-Abildgaard"
2025,"Como","Serie A","Dele Alli","ENG","MF","29-046",1996,0.1,0,0,0,0,0,0,0,NA,0,0,0,0,0,0,0,0,"https://fbref.com/en/players/cea4ee8f/Dele-Alli"
2025,"Como","Serie A","Emil Audero","IDN","GK","28-129",1997,8,0,0,0,0,0,0,1,0,1,0,0,0,0,0,4,1,"https://fbref.com/en/players/649b01d8/Emil-Audero"
2025,"Como","Serie A","Federico Barba","ITA","DF","31-268",1993,4.8,2,2,1,1,0,1,4,25,3,2,2,0,4,6,15,0,"https://fbref.com/en/players/c010b898/Federico-Barba"
2025,"Como","Serie A","Daniele Baselli","ITA","MF","33-076",1992,0.2,0,0,0,0,0,0,0,NA,0,0,0,0,1,1,1,0,"https://fbref.com/en/players/ea06dd97/Daniele-Baselli"
2025,"Como","Serie A","Andrea Belotti","ITA","FW","31-158",1993,6.6,7,5,1,4,2,1,4,25,3,4,0,4,1,8,8,0,"https://fbref.com/en/players/d705ba44/Andrea-Belotti"
2025,"Como","Serie A","Matthias Braunöder","AUT","MF","23-061",2002,3,10,4,6,3,1,7,11,63.6,4,3,0,3,2,12,4,1,"https://fbref.com/en/players/bce728e1/Matthias-Braunoder"
2025,"Como","Serie A","Jean Butez","FRA","GK","29-353",1995,18.5,0,0,0,0,0,0,2,0,2,0,0,0,0,0,18,1,"https://fbref.com/en/players/7f40333d/Jean-Butez"
2025,"Como","Serie A","Maxence Caqueret","FRA","MF","25-101",2000,12.1,36,21,14,18,4,20,38,52.6,18,15,1,14,7,43,4,1,"https://fbref.com/en/players/f81ef10d/Maxence-Caqueret"
2025,"Como","Serie A","Alberto Cerri","ITA","FW","29-041",1996,1,0,0,0,0,0,0,0,NA,0,2,0,2,0,0,1,0,"https://fbref.com/en/players/1079c685/Alberto-Cerri"
2025,"Como","Serie A","Patrick Cutrone","ITA","FW","27-144",1998,22.7,16,11,0,10,6,7,14,50,7,11,0,11,5,21,7,0,"https://fbref.com/en/players/a4fe8cda/Patrick-Cutrone"
2025,"Como","Serie A","Lucas Da Cunha","FRA","MF","23-352",2001,29,45,25,17,19,9,20,39,51.3,19,18,3,15,17,62,30,1,"https://fbref.com/en/players/007faf7a/Lucas-Da-Cunha"
2025,"Como","Serie A","Assane Diao","SEN","FW,MF","19-262",2005,13.9,25,14,9,10,6,12,28,42.9,16,8,1,7,3,28,19,0,"https://fbref.com/en/players/8ae7d0ec/Assane-Diao"
2025,"Como","Serie A","Alberto Dossena","ITA","DF","26-226",1998,20.3,33,20,23,8,2,16,28,57.1,12,22,11,11,22,55,89,1,"https://fbref.com/en/players/61efb926/Alberto-Dossena"
2025,"Como","Serie A","Anastasios Douvikas","GRE","FW","25-298",1999,6.4,3,2,0,3,0,1,4,25,3,3,0,3,1,4,3,0,"https://fbref.com/en/players/853ca71c/Anastasios-Douvikas"
2025,"Como","Serie A","Yannik Engelhardt","GER","MF,DF","24-109",2001,12.9,30,12,13,13,4,16,27,59.3,11,13,6,7,11,41,27,0,"https://fbref.com/en/players/fac66db3/Yannik-Engelhardt"
2025,"Como","Serie A","Alieu Fadera","GAM","FW,DF","23-205",2001,18.3,64,47,25,27,12,20,45,44.4,25,18,1,17,12,76,10,0,"https://fbref.com/en/players/53210e42/Alieu-Fadera"
2025,"Como","Serie A","Alessandro Gabrielloni","ITA","FW,MF","30-321",1994,1.6,0,0,0,0,0,0,3,0,3,0,0,0,0,0,1,0,"https://fbref.com/en/players/181cb492/Alessandro-Gabrielloni"
2025,"Como","Serie A","Edoardo Goldaniga","ITA","DF","31-206",1993,28.1,34,21,21,8,5,13,18,72.2,5,21,10,11,33,67,102,3,"https://fbref.com/en/players/4b029b31/Edoardo-Goldaniga"
2025,"Como","Serie A","Jonathan Ikone","FRA","FW","27-025",1998,6,15,9,4,3,8,6,11,54.5,5,5,1,4,0,15,1,1,"https://fbref.com/en/players/42eaa028/Jonathan-Ikone"
2025,"Como","Serie A","Alessio Iovine","ITA","DF,FW","34-115",1991,4.3,5,2,2,3,0,4,10,40,6,7,1,6,3,8,21,1,"https://fbref.com/en/players/083d7173/Alessio-Iovine"
2025,"Como","Serie A","Fellipe Jack","BRA","DF","19-135",2006,1.9,9,4,8,1,0,3,5,60,2,2,2,0,4,13,5,0,"https://fbref.com/en/players/cace4967/Fellipe-Jack"
2025,"Como","Serie A","Ali Jasim","IRQ","FW,DF","21-127",2004,0.1,1,0,1,0,0,1,1,100,0,0,0,0,0,1,0,0,"https://fbref.com/en/players/1a927a6f/Ali-Jasim"
2025,"Como","Serie A","Marc-Oliver Kempf","GER","DF","30-119",1995,29.1,30,20,15,14,1,13,24,54.2,11,35,26,9,33,63,136,4,"https://fbref.com/en/players/815c314f/Marc-Oliver-Kempf"
2025,"Como","Serie A","Ben Lhassine Kone","CIV","MF","25-074",2000,0.6,2,2,1,0,1,2,3,66.7,1,0,0,0,1,3,1,0,"https://fbref.com/en/players/7452c7a8/Ben-Lhassine-Kone"
2025,"Como","Serie A","Luca Mazzitelli","ITA","MF","29-193",1995,3.7,9,6,4,5,0,5,7,71.4,2,5,2,3,3,12,10,0,"https://fbref.com/en/players/dc61b402/Luca-Mazzitelli"
2025,"Como","Serie A","Alberto Moreno","ESP","DF","32-326",1992,19.2,25,11,17,8,0,12,26,46.2,14,12,3,9,14,39,40,2,"https://fbref.com/en/players/11b9265b/Alberto-Moreno"
2025,"Como","Serie A","Nicolás Paz","ARG","MF,FW","20-261",2004,29.9,51,33,18,26,7,24,51,47.1,27,49,3,46,21,72,16,0,"https://fbref.com/en/players/01bb93d5/Nicolas-Paz"
2025,"Como","Serie A","Máximo Perrone","ARG","MF","22-140",2003,20.6,38,27,19,14,5,13,38,34.2,25,15,2,13,20,58,43,0,"https://fbref.com/en/players/53552942/Maximo-Perrone"
2025,"Como","Serie A","Pepe Reina","ESP","GK","42-269",1982,11.5,0,0,0,0,0,0,1,0,1,0,0,0,0,0,3,2,"https://fbref.com/en/players/e358587b/Pepe-Reina"
2025,"Como","Serie A","Sergi Roberto","ESP","MF","33-109",1992,7.7,14,8,5,5,4,5,7,71.4,2,7,1,6,9,23,14,0,"https://fbref.com/en/players/335fa267/Sergi-Roberto"
2025,"Como","Serie A","Marco Sala","ITA","DF","25-357",1999,2.9,9,6,5,3,1,5,8,62.5,3,2,0,2,1,10,9,0,"https://fbref.com/en/players/0c57be8b/Marco-Sala"
2025,"Como","Serie A","Ivan Smolčić","CRO","DF","24-283",2000,7,16,9,8,7,1,9,13,69.2,4,8,2,6,10,26,24,0,"https://fbref.com/en/players/08e57960/Ivan-Smolcic"
2025,"Como","Serie A","Gabriel Strefezza","BRA","FW,MF","28-039",1997,29.1,57,39,20,20,17,21,55,38.2,34,24,2,22,13,70,26,0,"https://fbref.com/en/players/ac4a4508/Gabriel-Strefezza"
2025,"Como","Serie A","Álex Valle","ESP","DF","21-032",2004,11.4,26,12,12,12,2,15,21,71.4,6,13,2,11,8,34,42,0,"https://fbref.com/en/players/97022551/Alex-Valle"
2025,"Como","Serie A","Ignace Van Der Brempt","BEL","DF","23-056",2002,14,40,32,27,10,3,24,33,72.7,9,14,5,9,17,57,34,0,"https://fbref.com/en/players/2bf50b37/Ignace-Van-Der-Brempt"
2025,"Como","Serie A","Simone Verdi","ITA","MF,FW","32-319",1992,1.3,2,2,0,1,1,0,2,0,2,2,0,2,0,2,2,0,"https://fbref.com/en/players/0375723e/Simone-Verdi"
2025,"Como","Serie A","Mërgim Vojvoda","KVX","DF","30-115",1995,8,9,6,5,4,0,7,9,77.8,2,7,4,3,3,12,18,0,"https://fbref.com/en/players/be2706c0/Mergim-Vojvoda"
2025,"Crystal Palace","Premier League","Asher Agbinone","ENG","MF","19-241",2005,0.1,2,1,0,2,0,0,0,NA,0,0,0,0,0,2,0,0,"https://fbref.com/en/players/6a10efb3/Asher-Agbinone"
2025,"Crystal Palace","Premier League","Joachim Andersen","DEN","DF","28-361",1996,1,1,1,1,0,0,1,2,50,1,0,0,0,0,1,7,0,"https://fbref.com/en/players/e34fc66d/Joachim-Andersen"
2025,"Crystal Palace","Premier League","Jordan Ayew","GHA","FW,MF","33-258",1991,0.2,1,0,0,0,1,0,0,NA,0,0,0,0,0,1,0,0,"https://fbref.com/en/players/da052c14/Jordan-Ayew"
2025,"Crystal Palace","Premier League","Trevoh Chalobah","ENG","DF","25-326",1999,11.8,20,16,7,12,1,12,23,52.2,11,19,9,10,19,39,57,3,"https://fbref.com/en/players/5515376c/Trevoh-Chalobah"
2025,"Crystal Palace","Premier League","Ben Chilwell","ENG","DF","28-157",1996,2.9,7,6,4,3,0,1,5,20,4,6,2,4,6,13,16,0,"https://fbref.com/en/players/d2424d1b/Ben-Chilwell"
2025,"Crystal Palace","Premier League","Nathaniel Clyne","ENG","DF,MF","34-052",1991,5.4,12,8,8,3,1,6,11,54.5,5,4,2,2,3,15,14,1,"https://fbref.com/en/players/0442183b/Nathaniel-Clyne"
2025,"Crystal Palace","Premier League","Justin Devenny","NIR","MF","21-228",2003,5.6,17,12,7,9,1,8,19,42.1,11,6,1,5,0,17,11,0,"https://fbref.com/en/players/6c2b66fc/Justin-Devenny"
2025,"Crystal Palace","Premier League","Cheick Doucouré","MLI","MF","25-139",2000,5,16,8,6,8,2,5,11,45.5,6,4,0,4,11,27,10,1,"https://fbref.com/en/players/ce4f40c7/Cheick-Doucoure"
2025,"Crystal Palace","Premier League","Odsonne Édouard","FRA","MF,FW","27-131",1998,1.3,1,0,0,1,0,0,2,0,2,1,0,1,0,1,1,0,"https://fbref.com/en/players/0562b7f1/Odsonne-Edouard"
2025,"Crystal Palace","Premier League","Romain Esse","ENG","MF","20-014",2005,1.5,8,6,4,2,2,5,5,100,0,2,0,2,1,9,2,0,"https://fbref.com/en/players/87189f25/Romain-Esse"
2025,"Crystal Palace","Premier League","Eberechi Eze","ENG","MF,FW","26-332",1998,28.8,39,22,14,16,9,17,36,47.2,19,27,0,27,11,50,10,3,"https://fbref.com/en/players/ae4fc6a4/Eberechi-Eze"
2025,"Crystal Palace","Premier League","Matheus França","BRA","MF,FW","21-056",2004,0.6,2,0,0,2,0,0,0,NA,0,1,1,0,1,3,1,0,"https://fbref.com/en/players/077faf72/Matheus-Franca"
2025,"Crystal Palace","Premier League","Marc Guéhi","ENG","DF","24-318",2000,34,61,34,36,23,2,31,47,66,16,55,23,32,28,89,162,2,"https://fbref.com/en/players/d0706b27/Marc-Guehi"
2025,"Crystal Palace","Premier League","Dean Henderson","ENG","GK","28-076",1997,38,2,1,2,0,0,2,6,33.3,4,0,0,0,0,2,22,0,"https://fbref.com/en/players/e5a76dfe/Dean-Henderson"
2025,"Crystal Palace","Premier League","Will Hughes","ENG","MF","30-040",1995,23.4,66,36,20,33,13,28,62,45.2,34,31,14,17,21,87,28,3,"https://fbref.com/en/players/a0666d3e/Will-Hughes"
2025,"Crystal Palace","Premier League","Daichi Kamada","JPN","MF","28-295",1996,17.4,47,29,19,24,4,14,41,34.1,27,22,5,17,18,65,14,0,"https://fbref.com/en/players/15b287da/Daichi-Kamada"
2025,"Crystal Palace","Premier League","Caleb Kporha","ENG","DF","18-316",2006,0.1,2,1,2,0,0,2,2,100,0,0,0,0,0,2,1,0,"https://fbref.com/en/players/c80f8c9d/Caleb-Kporha"
2025,"Crystal Palace","Premier League","Maxence Lacroix","FRA","DF","25-051",2000,34.6,68,41,52,15,1,32,47,68.1,15,48,22,26,54,122,207,2,"https://fbref.com/en/players/277c49ed/Maxence-Lacroix"
2025,"Crystal Palace","Premier League","Jefferson Lerma","COL","MF,DF","30-214",1994,25.3,35,17,15,16,4,20,37,54.1,17,38,18,20,42,77,80,1,"https://fbref.com/en/players/9b5ce51a/Jefferson-Lerma"
2025,"Crystal Palace","Premier League","Jean-Philippe Mateta","FRA","FW","27-333",1997,29.4,18,12,5,11,2,3,16,18.8,13,18,4,14,2,20,23,0,"https://fbref.com/en/players/50e6dc35/Jean-Philippe-Mateta"
2025,"Crystal Palace","Premier League","Tyrick Mitchell","ENG","DF","25-268",1999,34.4,91,55,57,27,7,25,46,54.3,21,68,12,56,19,110,108,2,"https://fbref.com/en/players/5cbd1eb0/Tyrick-Mitchell"
2025,"Crystal Palace","Premier League","Daniel Muñoz","COL","DF","29-001",1996,35.9,123,80,57,41,25,55,96,57.3,41,40,6,34,44,167,108,1,"https://fbref.com/en/players/778ef829/Daniel-Munoz"
2025,"Crystal Palace","Premier League","Eddie Nketiah","ENG","FW,MF","25-362",1999,11.5,15,8,7,4,4,6,12,50,6,10,1,9,3,18,12,0,"https://fbref.com/en/players/a53649b7/Eddie-Nketiah"
2025,"Crystal Palace","Premier League","Chadi Riad","MAR","DF","21-344",2003,1,5,2,2,2,1,2,3,66.7,1,0,0,0,2,7,0,0,"https://fbref.com/en/players/b3b9b8b8/Chadi-Riad"
2025,"Crystal Palace","Premier League","Chris Richards","USA","DF","25-060",2000,21.4,47,30,24,17,6,24,41,58.5,17,40,14,26,19,66,121,0,"https://fbref.com/en/players/0a3d6d2b/Chris-Richards"
2025,"Crystal Palace","Premier League","Ismaila Sarr","SEN","MF","27-091",1998,30.1,22,10,10,9,3,8,25,32,17,27,8,19,9,31,40,0,"https://fbref.com/en/players/bfdb33aa/Ismaila-Sarr"
2025,"Crystal Palace","Premier League","Jeffrey Schlupp","GHA","MF,DF","32-155",1992,1.1,2,0,1,0,1,0,3,0,3,6,0,6,0,2,2,0,"https://fbref.com/en/players/3312f911/Jeffrey-Schlupp"
2025,"Crystal Palace","Premier League","Joel Ward","ENG","DF","35-210",1989,0.8,2,0,0,2,0,0,0,NA,0,0,0,0,0,2,3,0,"https://fbref.com/en/players/8a7ff278/Joel-Ward"
2025,"Crystal Palace","Premier League","Adam Wharton","ENG","MF","20-359",2004,14.6,34,14,14,16,4,17,44,38.6,27,11,2,9,20,54,27,0,"https://fbref.com/en/players/4b542852/Adam-Wharton"
2025,"Dortmund","Bundesliga","Karim Adeyemi","GER","FW,MF","23-129",2002,15.9,20,14,6,6,8,8,20,40,12,14,1,13,7,27,5,0,"https://fbref.com/en/players/501055d8/Karim-Adeyemi"
2025,"Dortmund","Bundesliga","Waldemar Anton","GER","DF","28-311",1996,21.7,34,21,18,10,6,17,23,73.9,6,33,16,17,30,64,112,1,"https://fbref.com/en/players/5e66fa06/Waldemar-Anton"
2025,"Dortmund","Bundesliga","Ayman Azhil","MAR","MF","24-047",2001,0.3,1,1,1,0,0,0,0,NA,0,0,0,0,0,1,0,0,"https://fbref.com/en/players/ce81d82d/Ayman-Azhil"
2025,"Dortmund","Bundesliga","Maximilian Beier","GER","FW,MF","22-222",2002,17.7,25,16,8,11,6,12,31,38.7,19,15,1,14,7,32,14,1,"https://fbref.com/en/players/5db45ee5/Maximilian-Beier"
2025,"Dortmund","Bundesliga","Ramy Bensebaini","ALG","DF","30-041",1995,22.5,51,25,25,18,8,33,51,64.7,18,42,9,33,33,84,86,1,"https://fbref.com/en/players/378825c7/Ramy-Bensebaini"
2025,"Dortmund","Bundesliga","Julian Brandt","GER","MF","29-025",1996,25.6,26,11,13,8,5,15,43,34.9,28,17,0,17,14,40,13,1,"https://fbref.com/en/players/a167537f/Julian-Brandt"
2025,"Dortmund","Bundesliga","Cole Campbell","USA","MF,FW","19-096",2006,0.2,0,0,0,0,0,0,0,NA,0,0,0,0,0,0,1,0,"https://fbref.com/en/players/fbb270b2/Cole-Campbell"
2025,"Dortmund","Bundesliga","Emre Can","GER","DF,MF","31-135",1994,23.4,50,28,30,16,4,18,36,50,18,31,17,14,20,70,89,3,"https://fbref.com/en/players/a65ce836/Emre-Can"
2025,"Dortmund","Bundesliga","Carney Chukwuemeka","ENG","MF","21-219",2003,2.8,7,5,3,2,2,1,1,100,0,5,0,5,1,8,1,0,"https://fbref.com/en/players/b2f9c73e/Carney-Chukwuemeka"
2025,"Dortmund","Bundesliga","Yan Couto","BRA","DF,FW","22-358",2002,9.9,24,16,17,2,5,14,25,56,11,12,1,11,10,34,32,2,"https://fbref.com/en/players/1944818c/Yan-Couto"
2025,"Dortmund","Bundesliga","Julien Duranville","BEL","FW,MF","19-022",2006,3.1,3,0,0,3,0,1,2,50,1,1,0,1,0,3,3,0,"https://fbref.com/en/players/b06a7ae9/Julien-Duranville"
2025,"Dortmund","Bundesliga","Jamie Gittens","ENG","FW,MF","20-292",2004,19.7,31,19,12,12,7,14,18,77.8,4,16,0,16,10,41,4,0,"https://fbref.com/en/players/10745192/Jamie-Gittens"
2025,"Dortmund","Bundesliga","Pascal Groß","GER","MF,DF","33-346",1991,25.9,44,28,11,26,7,15,51,29.4,36,46,13,33,9,53,30,1,"https://fbref.com/en/players/8aec0537/Pascal-Gross"
2025,"Dortmund","Bundesliga","Serhou Guirassy","GUI","FW","29-076",1996,28.9,7,6,2,2,3,2,5,40,3,10,3,7,4,11,38,0,"https://fbref.com/en/players/923f4dda/Serhou-Guirassy"
2025,"Dortmund","Bundesliga","Almugera Kabar","GER","DF","18-355",2006,1.5,5,3,2,2,1,3,3,100,0,1,0,1,1,6,4,0,"https://fbref.com/en/players/02a10dc0/Almugera-Kabar"
2025,"Dortmund","Bundesliga","Gregor Kobel","SUI","GK","27-172",1997,32,0,0,0,0,0,0,0,NA,0,0,0,0,1,1,23,3,"https://fbref.com/en/players/cd59b9df/Gregor-Kobel"
2025,"Dortmund","Bundesliga","Yannik Lührs","GER","DF","21-260",2003,1.4,1,1,1,0,0,0,0,NA,0,0,0,0,2,3,4,0,"https://fbref.com/en/players/10e5f256/Yannik-Luhrs"
2025,"Dortmund","Bundesliga","Donyell Malen","NED","FW,MF","26-138",1999,6.8,0,0,0,0,0,0,2,0,2,2,0,2,3,3,6,0,"https://fbref.com/en/players/116c35df/Donyell-Malen"
2025,"Dortmund","Bundesliga","Alexander Meyer","GER","GK","34-044",1991,2,0,0,0,0,0,0,0,NA,0,0,0,0,0,0,0,0,"https://fbref.com/en/players/b56dd813/Alexander-Meyer"
2025,"Dortmund","Bundesliga","Felix Nmecha","GER","MF","24-229",2000,16.8,34,22,6,19,9,12,22,54.5,10,20,5,15,23,57,30,1,"https://fbref.com/en/players/091c86e2/Felix-Nmecha"
2025,"Dortmund","Bundesliga","Salih Özcan","TUR","MF","27-136",1998,4.3,11,7,6,4,1,7,13,53.8,6,7,0,7,11,22,10,0,"https://fbref.com/en/players/15413fa5/Salih-Ozcan"
2025,"Dortmund","Bundesliga","Gio Reyna","USA","MF","22-195",2002,3.9,7,0,3,0,4,4,5,80,1,3,1,2,0,7,9,0,"https://fbref.com/en/players/7fa4e703/Gio-Reyna"
2025,"Dortmund","Bundesliga","Julian Ryerson","NOR","DF","27-191",1997,25.1,46,30,26,13,7,25,44,56.8,19,29,2,27,22,68,26,1,"https://fbref.com/en/players/009a4f60/Julian-Ryerson"
2025,"Dortmund","Bundesliga","Marcel Sabitzer","AUT","MF","31-071",1994,18,29,19,7,15,7,16,27,59.3,11,19,6,13,10,39,29,1,"https://fbref.com/en/players/e280527c/Marcel-Sabitzer"
2025,"Dortmund","Bundesliga","Nico Schlotterbeck","GER","DF","25-177",1999,22,38,24,21,16,1,27,45,60,18,31,15,16,22,60,79,1,"https://fbref.com/en/players/34e12499/Nico-Schlotterbeck"
2025,"Dortmund","Bundesliga","Niklas Süle","GER","DF","29-266",1995,11.7,14,12,9,5,0,10,14,71.4,4,11,6,5,4,18,46,1,"https://fbref.com/en/players/e33c06cf/Niklas-Sule"
2025,"Dortmund","Bundesliga","Daniel Svensson","SWE","DF,FW","23-104",2002,8.7,15,11,5,6,4,7,11,63.6,4,10,4,6,5,20,30,0,"https://fbref.com/en/players/124c9382/Daniel-Svensson"
2025,"Dortmund","Bundesliga","Kjell-Arik Wätjen","GER","MF","19-100",2006,0.2,0,0,0,0,0,0,0,NA,0,0,0,0,0,0,2,0,"https://fbref.com/en/players/0e006cae/Kjell-Arik-Watjen"
2025,"Eint Frankfurt","Bundesliga","Aurele Amenda","SUI","DF","21-300",2003,1.1,1,0,1,0,0,0,0,NA,0,2,2,0,2,3,11,0,"https://fbref.com/en/players/1227a22d/Aurele-Amenda"
2025,"Eint Frankfurt","Bundesliga","Michy Batshuayi","BEL","FW","31-237",1993,3.3,1,1,1,0,0,1,1,100,0,2,0,2,1,2,0,0,"https://fbref.com/en/players/2973d8ff/Michy-Batshuayi"
2025,"Eint Frankfurt","Bundesliga","Nathaniel Brown","GER","DF,MF","21-345",2003,21.6,71,42,39,18,14,44,55,80,11,30,0,30,15,86,55,1,"https://fbref.com/en/players/abc79c47/Nathaniel-Brown"
2025,"Eint Frankfurt","Bundesliga","Fares Chaïbi","ALG","MF,FW","22-180",2002,11.3,13,9,4,5,4,7,20,35,13,10,0,10,10,23,32,1,"https://fbref.com/en/players/357103bd/Fares-Chaibi"
2025,"Eint Frankfurt","Bundesliga","Timothy Chandler","USA","DF","35-059",1990,0.3,0,0,0,0,0,0,0,NA,0,0,0,0,3,3,2,0,"https://fbref.com/en/players/b3b7f5a6/Timothy-Chandler"
2025,"Eint Frankfurt","Bundesliga","Nnamdi Collins","GER","DF","21-137",2004,16.5,33,24,24,7,2,17,22,77.3,5,22,11,11,16,49,74,3,"https://fbref.com/en/players/8eb5c94c/Nnamdi-Collins"
2025,"Eint Frankfurt","Bundesliga","Mahmoud Dahoud","GER","MF","29-146",1996,4,9,4,4,5,0,4,6,66.7,2,5,1,4,2,11,5,0,"https://fbref.com/en/players/db4ed67b/Mahmoud-Dahoud"
2025,"Eint Frankfurt","Bundesliga","Junior Dina Ebimbe","FRA","MF,FW","24-187",2000,3.3,3,2,1,2,0,1,3,33.3,2,4,0,4,7,10,6,0,"https://fbref.com/en/players/95bb6ddc/Junior-Dina-Ebimbe"
2025,"Eint Frankfurt","Bundesliga","Hugo Ekitike","FRA","FW","22-341",2002,28.5,16,12,3,8,5,4,12,33.3,8,13,1,12,7,23,24,0,"https://fbref.com/en/players/5b92d896/Hugo-Ekitike"
2025,"Eint Frankfurt","Bundesliga","Mario Götze","GER","MF,FW","32-358",1992,17.1,41,28,18,20,3,15,36,41.7,21,15,1,14,7,48,8,0,"https://fbref.com/en/players/9efa1d25/Mario-Gotze"
2025,"Eint Frankfurt","Bundesliga","Oscar Højlund","DEN","MF","20-143",2005,8,21,12,8,9,4,8,16,50,8,15,7,8,5,26,11,1,"https://fbref.com/en/players/3e2bbae6/Oscar-Hojlund"
2025,"Eint Frankfurt","Bundesliga","Ansgar Knauff","GER","MF,DF","23-137",2002,17.7,41,22,18,16,7,12,26,46.2,14,23,4,19,12,53,24,0,"https://fbref.com/en/players/19a967ab/Ansgar-Knauff"
2025,"Eint Frankfurt","Bundesliga","Robin Koch","GER","DF","28-314",1996,28.7,24,11,14,8,2,10,22,45.5,12,39,25,14,25,49,197,4,"https://fbref.com/en/players/ea6bc03a/Robin-Koch"
2025,"Eint Frankfurt","Bundesliga","Rasmus Kristensen","DEN","DF","27-320",1997,27.9,59,33,37,17,5,40,67,59.7,27,50,13,37,20,79,97,1,"https://fbref.com/en/players/39769cff/Rasmus-Kristensen"
2025,"Eint Frankfurt","Bundesliga","Hugo Larsson","SWE","MF","20-334",2004,26.6,47,27,17,25,5,21,42,50,21,42,11,31,30,77,35,1,"https://fbref.com/en/players/00c9a283/Hugo-Larsson"
2025,"Eint Frankfurt","Bundesliga","Omar Marmoush","EGY","FW","26-109",1999,16.1,12,8,0,3,9,3,7,42.9,4,7,1,6,2,14,2,0,"https://fbref.com/en/players/0e0102eb/Omar-Marmoush"
2025,"Eint Frankfurt","Bundesliga","Igor Matanovic","CRO","FW","22-057",2003,3.5,2,0,0,2,0,0,1,0,1,3,0,3,1,3,9,0,"https://fbref.com/en/players/948e1292/Igor-Matanovic"
2025,"Eint Frankfurt","Bundesliga","Jean Mattéo Bahoya","FRA","MF,FW","20-020",2005,10.2,29,18,11,13,5,16,26,61.5,10,14,2,12,4,33,10,1,"https://fbref.com/en/players/70d4c949/Jean-Matteo-Bahoya"
2025,"Eint Frankfurt","Bundesliga","Niels Nkounkou","FRA","DF,MF","24-207",2000,4.2,13,10,7,3,3,4,7,57.1,3,5,2,3,7,20,15,0,"https://fbref.com/en/players/f5b281e7/Niels-Nkounkou"
2025,"Eint Frankfurt","Bundesliga","Kauã Santos","BRA","GK","22-046",2003,8.5,0,0,0,0,0,0,0,NA,0,0,0,0,0,0,10,2,"https://fbref.com/en/players/c7c50cb5/Kaua-Santos"
2025,"Eint Frankfurt","Bundesliga","Ellyes Skhiri","TUN","MF","30-017",1995,24.8,40,22,15,21,4,18,44,40.9,26,30,7,23,31,71,45,4,"https://fbref.com/en/players/c2211709/Ellyes-Skhiri"
2025,"Eint Frankfurt","Bundesliga","Arthur Theate","BEL","DF","25-002",2000,30,36,25,19,16,1,22,44,50,22,42,19,23,39,75,170,3,"https://fbref.com/en/players/df8d6029/Arthur-Theate"
2025,"Eint Frankfurt","Bundesliga","Kevin Trapp","GER","GK","34-323",1990,25.5,0,0,0,0,0,0,0,NA,0,0,0,0,0,0,13,3,"https://fbref.com/en/players/ce17b5eb/Kevin-Trapp"
2025,"Eint Frankfurt","Bundesliga","Tuta","BRA","DF,MF","25-327",1999,25.3,44,27,25,17,2,28,40,70,12,42,21,21,40,84,135,1,"https://fbref.com/en/players/35d64857/Tuta"
2025,"Eint Frankfurt","Bundesliga","Can Uzun","TUR","MF,FW","19-197",2005,7.5,10,4,1,4,5,5,10,50,5,9,0,9,1,11,3,0,"https://fbref.com/en/players/1d0b134a/Can-Uzun"
2025,"Eint Frankfurt","Bundesliga","Elye Wahi","FRA","FW,MF","22-145",2003,2.2,0,0,0,0,0,0,1,0,1,1,0,1,0,0,1,0,"https://fbref.com/en/players/0d7b6576/Elye-Wahi"
2025,"Empoli","Serie A","Faustino Anjorin","ENG","MF","23-185",2001,12.4,29,13,9,14,6,9,18,50,9,18,3,15,13,42,20,0,"https://fbref.com/en/players/b105919e/Faustino-Anjorin"
2025,"Empoli","Serie A","Jacopo Bacci","ITA","MF","19-342",2005,0.3,1,0,1,0,0,1,1,100,0,0,0,0,1,2,1,0,"https://fbref.com/en/players/9ce30308/Jacopo-Bacci"
2025,"Empoli","Serie A","Liberato Cacace","NZL","MF,DF","24-242",2000,24.8,37,25,20,13,4,22,31,71,9,26,9,17,22,59,59,0,"https://fbref.com/en/players/dd86e8e4/Liberato-Cacace"
2025,"Empoli","Serie A","Thomas Campaniello","ITA","FW","17-087",2008,0.3,0,0,0,0,0,0,2,0,2,0,0,0,0,0,0,0,"https://fbref.com/en/players/cb88e494/Thomas-Campaniello"
2025,"Empoli","Serie A","Francesco Caputo","ITA","FW","37-294",1987,0.1,0,0,0,0,0,0,0,NA,0,0,0,0,0,0,0,0,"https://fbref.com/en/players/5bd72174/Francesco-Caputo"
2025,"Empoli","Serie A","Lorenzo Colombo","ITA","FW,MF","23-080",2002,24.8,31,14,7,16,8,7,21,33.3,14,33,2,31,2,33,16,1,"https://fbref.com/en/players/04df29a5/Lorenzo-Colombo"
2025,"Empoli","Serie A","Mattia De Sciglio","ITA","DF","32-219",1992,8.5,18,13,10,8,0,14,17,82.4,3,10,3,7,8,26,35,1,"https://fbref.com/en/players/ae4e2852/Mattia-De-Sciglio"
2025,"Empoli","Serie A","Tyronne Ebuehi","NGA","DF,MF","29-162",1995,0.8,3,2,1,2,0,1,1,100,0,1,0,1,2,5,0,0,"https://fbref.com/en/players/6af30900/Tyronne-Ebuehi"
2025,"Empoli","Serie A","Emmanuel Ekong","SWE","MF,FW","22-336",2002,2.1,4,3,0,2,2,3,3,100,0,2,1,1,1,5,1,0,"https://fbref.com/en/players/c20892ee/Emmanuel-Ekong"
2025,"Empoli","Serie A","Sebastiano Esposito","ITA","FW,MF","22-329",2002,25.9,57,29,15,31,11,18,35,51.4,17,20,2,18,12,69,14,0,"https://fbref.com/en/players/7ff93107/Sebastiano-Esposito"
2025,"Empoli","Serie A","Jacopo Fazzini","ITA","MF","22-072",2003,15.4,32,19,11,16,5,13,23,56.5,10,13,1,12,6,38,24,0,"https://fbref.com/en/players/06b08c45/Jacopo-Fazzini"
2025,"Empoli","Serie A","Saba Goglichidze","GEO","DF","20-336",2004,28.2,64,37,36,25,3,25,51,49,26,36,17,19,33,97,97,3,"https://fbref.com/en/players/011d370e/Saba-Goglichidze"
2025,"Empoli","Serie A","Alberto Grassi","ITA","MF","30-081",1995,24.5,39,21,16,18,5,14,22,63.6,8,22,12,10,33,72,43,1,"https://fbref.com/en/players/6cc97b6a/Alberto-Grassi"
2025,"Empoli","Serie A","Emmanuel Gyasi","GHA","DF,FW","31-136",1994,35.7,52,29,32,14,6,24,38,63.2,14,27,9,18,11,63,77,0,"https://fbref.com/en/players/f9758dae/Emmanuel-Gyasi"
2025,"Empoli","Serie A","Nicolas Haas","SUI","MF","29-124",1996,3.2,11,8,4,5,2,5,9,55.6,4,2,1,1,4,15,6,0,"https://fbref.com/en/players/fa449bba/Nicolas-Haas"
2025,"Empoli","Serie A","Liam Henderson","SCO","MF","29-032",1996,26,42,22,17,22,3,22,53,41.5,31,19,5,14,15,57,42,0,"https://fbref.com/en/players/d7918b13/Liam-Henderson"
2025,"Empoli","Serie A","Ardian Ismajli","ALB","DF","28-239",1996,27.9,30,23,21,9,0,16,20,80,4,35,24,11,56,86,249,3,"https://fbref.com/en/players/6b635f5c/Ardian-Ismajli"
2025,"Empoli","Serie A","Ismael Konate","CIV","FW,MF","19-059",2006,1.3,4,2,4,0,0,2,3,66.7,1,3,2,1,0,4,1,0,"https://fbref.com/en/players/351ab035/Ismael-Konate"
2025,"Empoli","Serie A","Christian Kouamé","CIV","FW,MF","27-172",1997,5.6,5,4,0,3,2,2,4,50,2,4,2,2,0,5,4,0,"https://fbref.com/en/players/58e933d2/Christian-Kouame"
2025,"Empoli","Serie A","Viktor Kovalenko","UKR","MF","29-102",1996,0.9,2,1,0,2,0,0,1,0,1,0,0,0,0,2,0,0,"https://fbref.com/en/players/9d60028d/Viktor-Kovalenko"
2025,"Empoli","Serie A","Youssef Maleh","MAR","MF","26-278",1998,16.8,45,23,17,23,5,17,34,50,17,25,6,19,16,61,25,0,"https://fbref.com/en/players/4c8845f7/Youssef-Maleh"
2025,"Empoli","Serie A","Luca Marianucci","ITA","DF","20-308",2004,11.9,28,12,17,11,0,11,19,57.9,8,16,8,8,19,47,63,1,"https://fbref.com/en/players/64e6778a/Luca-Marianucci"
2025,"Empoli","Serie A","Pietro Pellegri","ITA","FW","24-071",2001,4.6,7,2,0,6,1,2,4,50,2,2,0,2,0,7,3,0,"https://fbref.com/en/players/a44d3a3c/Pietro-Pellegri"
2025,"Empoli","Serie A","Giuseppe Pezzella","ITA","DF,FW","27-179",1997,32,55,31,28,17,10,29,57,50.9,28,32,8,24,15,70,110,2,"https://fbref.com/en/players/149c5f5d/Giuseppe-Pezzella"
2025,"Empoli","Serie A","Junior Sambia","FRA","DF,FW","28-262",1996,4.3,14,10,3,6,5,11,11,100,0,3,0,3,2,16,5,0,"https://fbref.com/en/players/24eb7ed6/Junior-Sambia"
2025,"Empoli","Serie A","Jacopo Seghetti","ITA","GK","20-099",2005,1,0,0,0,0,0,0,0,NA,0,0,0,0,0,0,0,0,"https://fbref.com/en/players/70a10677/Jacopo-Seghetti"
2025,"Empoli","Serie A","Marco Silvestri","ITA","GK","34-086",1991,5,0,0,0,0,0,0,2,0,2,0,0,0,0,0,3,1,"https://fbref.com/en/players/0d422df7/Marco-Silvestri"
2025,"Empoli","Serie A","Ola Solbakken","NOR","MF,FW","26-262",1998,8.4,7,4,0,6,1,3,6,50,3,0,0,0,2,9,8,0,"https://fbref.com/en/players/78f13530/Ola-Solbakken"
2025,"Empoli","Serie A","Petar Stojanović","SVN","MF","29-232",1995,0,0,0,0,0,0,0,0,NA,0,0,0,0,0,0,0,0,"https://fbref.com/en/players/13b44b02/Petar-Stojanovic"
2025,"Empoli","Serie A","Lorenzo Tosto","ITA","DF","19-118",2006,0,0,0,0,0,0,0,0,NA,0,0,0,0,0,0,0,0,"https://fbref.com/en/players/a8c67cdb/Lorenzo-Tosto"
2025,"Empoli","Serie A","Devis Vásquez","COL","GK","27-015",1998,32,0,0,0,0,0,0,0,NA,0,0,0,0,0,0,21,4,"https://fbref.com/en/players/fac1f795/Devis-Vasquez"
2025,"Empoli","Serie A","Mattia Viti","ITA","DF","23-123",2002,28.6,65,45,42,20,3,34,52,65.4,18,41,18,23,48,113,128,4,"https://fbref.com/en/players/75438a9a/Mattia-Viti"
2025,"Empoli","Serie A","Sebastian Walukiewicz","POL","DF","25-052",2000,2,1,0,1,0,0,0,1,0,1,3,3,0,1,2,15,0,"https://fbref.com/en/players/217875a4/Sebastian-Walukiewicz"
2025,"Empoli","Serie A","Szymon Żurkowski","POL","MF","27-244",1997,1.2,6,4,2,4,0,4,4,100,0,3,0,3,1,7,2,0,"https://fbref.com/en/players/4e1d5e59/Szymon-Zurkowski"
2025,"Espanyol","La Liga","Álvaro Aguado","ESP","MF","29-026",1996,4.9,5,2,3,2,0,3,9,33.3,6,7,1,6,4,9,5,1,"https://fbref.com/en/players/014aa7bd/Alvaro-Aguado"
2025,"Espanyol","La Liga","Antoniu","ESP","FW,MF","22-264",2002,11.4,21,10,9,8,4,9,21,42.9,12,14,2,12,8,29,11,1,"https://fbref.com/en/players/af784a9e/Antoniu"
2025,"Espanyol","La Liga","Rafael Bauza","ESP","MF","20-117",2005,2,5,3,3,1,1,4,7,57.1,3,3,1,2,0,5,5,0,"https://fbref.com/en/players/c6b930b1/Rafael-Bauza"
2025,"Espanyol","La Liga","Leandro Cabrera","URU","DF","33-344",1991,31.9,40,23,29,8,3,19,33,57.6,14,35,25,10,30,70,199,2,"https://fbref.com/en/players/69cbc8b6/Leandro-Cabrera"
2025,"Espanyol","La Liga","Fernando Calero","ESP","DF,MF","29-255",1995,7.9,18,10,13,4,1,8,12,66.7,4,16,9,7,16,34,50,1,"https://fbref.com/en/players/41b3069f/Fernando-Calero"
2025,"Espanyol","La Liga","Irvin Cardona","FRA","FW,MF","27-292",1997,6.7,8,5,2,4,2,6,16,37.5,10,5,1,4,4,12,10,0,"https://fbref.com/en/players/5e080f73/Irvin-Cardona"
2025,"Espanyol","La Liga","Walid Cheddira","MAR","FW","27-125",1998,7.1,5,0,1,1,3,0,1,0,1,4,0,4,1,6,6,0,"https://fbref.com/en/players/0545a08e/Walid-Cheddira"
2025,"Espanyol","La Liga","Edu Expósito","ESP","MF","28-299",1996,11.6,23,13,9,13,1,9,23,39.1,14,3,0,3,15,38,21,2,"https://fbref.com/en/players/283c7121/Edu-Exposito"
2025,"Espanyol","La Liga","Roberto Férnandez","ESP","FW","22-328",2002,16.6,4,4,2,1,1,0,5,0,5,9,1,8,3,7,26,0,"https://fbref.com/en/players/c981fc98/Roberto-Fernandez"
2025,"Espanyol","La Liga","Joan García","ESP","GK","24-023",2001,38,0,0,0,0,0,0,1,0,1,1,0,1,0,0,18,4,"https://fbref.com/en/players/87b498b0/Joan-Garcia"
2025,"Espanyol","La Liga","Sergi Gómez","ESP","DF","33-060",1992,7.4,8,5,7,1,0,2,3,66.7,1,12,8,4,7,15,38,0,"https://fbref.com/en/players/bc6f5f06/Sergi-Gomez"
2025,"Espanyol","La Liga","Urko González","ESP","MF","24-068",2001,15.3,46,28,24,21,1,28,44,63.6,16,27,12,15,8,54,39,1,"https://fbref.com/en/players/c4f5eb61/Urko-Gonzalez"
2025,"Espanyol","La Liga","José Gragera","ESP","MF","24-178",2000,6.3,25,16,11,14,0,9,17,52.9,8,9,1,8,5,30,13,0,"https://fbref.com/en/players/ee45d138/Jose-Gragera"
2025,"Espanyol","La Liga","Omar El Hilali","MAR","DF","21-257",2003,35,111,79,81,24,6,64,95,67.4,31,53,13,40,46,157,145,2,"https://fbref.com/en/players/139560df/Omar-El-Hilali"
2025,"Espanyol","La Liga","Roger Hinojo","ESP","DF","20-095",2005,0.1,0,0,0,0,0,0,0,NA,0,0,0,0,0,0,1,0,"https://fbref.com/en/players/1c33932b/Roger-Hinojo"
2025,"Espanyol","La Liga","Jofre","ESP","MF,FW","23-344",2001,24.1,22,16,14,5,3,13,23,56.5,10,13,0,13,15,37,29,0,"https://fbref.com/en/players/030ef8d6/Jofre"
2025,"Espanyol","La Liga","Alex Král","CZE","MF","27-008",1998,30.2,55,37,28,24,3,16,30,53.3,14,34,14,20,28,83,51,2,"https://fbref.com/en/players/e717705a/Alex-Kral"
2025,"Espanyol","La Liga","Marash Kumbulla","ALB","DF","25-108",2000,33,51,26,35,14,2,24,41,58.5,17,48,35,13,34,85,224,2,"https://fbref.com/en/players/a40819d9/Marash-Kumbulla"
2025,"Espanyol","La Liga","Pol Lozano","ESP","MF","25-233",1999,21.6,53,34,23,25,5,25,58,43.1,33,32,6,26,22,75,31,0,"https://fbref.com/en/players/ea610f00/Pol-Lozano"
2025,"Espanyol","La Liga","Pere Milla","ESP","MF,FW","32-246",1992,5.1,6,2,5,0,1,1,18,5.6,17,10,2,8,3,9,5,0,"https://fbref.com/en/players/335039a2/Pere-Milla"
2025,"Espanyol","La Liga","Brian Oliván","ESP","DF","31-056",1994,11.3,13,10,7,6,0,4,13,30.8,9,6,2,4,10,23,23,0,"https://fbref.com/en/players/a3e4bf46/Brian-Olivan"
2025,"Espanyol","La Liga","Javi Puado","ESP","FW,MF","27-002",1998,33,22,17,14,4,4,8,20,40,12,18,3,15,5,27,19,0,"https://fbref.com/en/players/2683eda7/Javi-Puado"
2025,"Espanyol","La Liga","Carlos Romero","ESP","DF","23-210",2001,28.4,73,47,49,16,8,45,82,54.9,37,50,15,35,30,103,102,1,"https://fbref.com/en/players/23cbf863/Carlos-Romero"
2025,"Espanyol","La Liga","Justin Smith","CAN","MF","22-112",2003,2.3,9,3,3,6,0,4,6,66.7,2,5,1,4,4,13,3,0,"https://fbref.com/en/players/a496d4a2/Justin-Smith"
2025,"Espanyol","La Liga","Álvaro Tejero","ESP","MF,DF","28-311",1996,13.8,14,4,7,6,1,7,23,30.4,16,9,1,8,13,27,34,1,"https://fbref.com/en/players/868ce848/Alvaro-Tejero"
2025,"Espanyol","La Liga","Naci Ünüvar","NED","MF,DF","21-348",2003,0.3,2,2,1,1,0,1,2,50,1,0,0,0,0,2,0,0,"https://fbref.com/en/players/bf25cb29/Naci-Unuvar"
2025,"Espanyol","La Liga","Alejo Véliz","ARG","FW","21-250",2003,12.5,1,1,0,1,0,1,7,14.3,6,12,2,10,4,5,23,1,"https://fbref.com/en/players/3f7bafbe/Alejo-Veliz"
2025,"Everton","Premier League","Carlos Alcaraz","ARG","FW,MF","22-178",2002,8.5,11,5,5,3,3,3,11,27.3,8,9,2,7,5,16,10,0,"https://fbref.com/en/players/4abac767/Carlos-Alcaraz"
2025,"Everton","Premier League","Harrison Armstrong","ENG","MF","18-128",2007,0.5,0,0,0,0,0,0,1,0,1,0,0,0,0,0,1,0,"https://fbref.com/en/players/de59e609/Harrison-Armstrong"
2025,"Everton","Premier League","Beto","GNB","FW","27-116",1998,17,14,6,2,8,4,5,8,62.5,3,12,2,10,4,18,24,1,"https://fbref.com/en/players/ed5c0319/Beto"
2025,"Everton","Premier League","Jarrad Branthwaite","ENG","DF","22-334",2002,27.9,36,20,26,10,0,20,28,71.4,8,31,23,8,27,63,191,4,"https://fbref.com/en/players/c1949191/Jarrad-Branthwaite"
2025,"Everton","Premier League","Armando Broja","ALB","FW","23-259",2001,3.7,3,1,1,1,1,0,0,NA,0,3,0,3,1,4,4,0,"https://fbref.com/en/players/97220da2/Armando-Broja"
2025,"Everton","Premier League","Dominic Calvert-Lewin","ENG","FW","28-072",1997,17.9,9,7,1,4,4,2,6,33.3,4,7,2,5,7,16,23,0,"https://fbref.com/en/players/59e6e5bf/Dominic-Calvert-Lewin"
2025,"Everton","Premier League","Youssef Chermiti","POR","FW,MF","21-003",2004,0.5,0,0,0,0,0,0,1,0,1,0,0,0,0,0,0,0,"https://fbref.com/en/players/890f108d/Youssef-Chermiti"
2025,"Everton","Premier League","Séamus Coleman","IRL","DF","36-228",1988,2.4,3,2,2,1,0,3,4,75,1,5,3,2,1,4,8,0,"https://fbref.com/en/players/0420d84f/Seamus-Coleman"
2025,"Everton","Premier League","Roman Dixon","ENG","DF","20-152",2004,1,5,5,3,2,0,4,4,100,0,1,0,1,1,6,3,0,"https://fbref.com/en/players/6fba4dba/Roman-Dixon"
2025,"Everton","Premier League","Abdoulaye Doucouré","MLI","MF","32-146",1993,28.5,48,28,21,20,7,14,43,32.6,29,31,6,25,10,58,20,1,"https://fbref.com/en/players/02b29014/Abdoulaye-Doucoure"
2025,"Everton","Premier League","Idrissa Gana Gueye","SEN","MF","35-243",1989,34,133,80,61,55,17,58,99,58.6,41,48,9,39,48,181,36,1,"https://fbref.com/en/players/72c812f3/Idrissa-Gana-Gueye"
2025,"Everton","Premier League","James Garner","ENG","MF,DF","24-075",2001,17.7,47,31,25,20,2,24,41,58.5,17,20,4,16,23,70,37,0,"https://fbref.com/en/players/4e015693/James-Garner"
2025,"Everton","Premier League","Jack Harrison","ENG","FW","28-188",1996,23.1,32,22,12,12,8,15,46,32.6,31,18,2,16,10,42,35,2,"https://fbref.com/en/players/aa849a12/Jack-Harrison"
2025,"Everton","Premier League","Mason Holgate","ENG","FW,DF","28-217",1996,0.1,0,0,0,0,0,0,0,NA,0,0,0,0,0,0,0,0,"https://fbref.com/en/players/d0042ab9/Mason-Holgate"
2025,"Everton","Premier League","Tim Iroegbunam","ENG","MF","21-331",2003,6.4,29,14,14,10,5,14,23,60.9,9,18,4,14,16,45,12,1,"https://fbref.com/en/players/84c5ceea/Tim-Iroegbunam"
2025,"Everton","Premier League","Michael Keane","ENG","DF","32-136",1993,11.7,12,9,8,2,2,8,15,53.3,7,14,10,4,16,28,65,2,"https://fbref.com/en/players/c5b7c315/Michael-Keane"
2025,"Everton","Premier League","Jesper Lindstrøm","DEN","FW","25-087",2000,13.8,45,25,24,19,2,19,55,34.5,36,15,3,12,12,57,17,0,"https://fbref.com/en/players/37dc1a48/Jesper-Lindstrom"
2025,"Everton","Premier League","Orel Mangala","BEL","MF","27-070",1998,14,16,8,3,11,2,5,8,62.5,3,8,3,5,21,37,24,1,"https://fbref.com/en/players/a572e291/Orel-Mangala"
2025,"Everton","Premier League","Dwight McNeil","ENG","MF,FW","25-186",1999,15.2,13,8,6,5,2,9,21,42.9,12,7,0,7,6,19,2,1,"https://fbref.com/en/players/fc15fb84/Dwight-McNeil"
2025,"Everton","Premier League","Vitaliy Mykolenko","UKR","DF","25-363",1999,34.2,63,38,39,14,10,29,56,51.8,27,25,10,15,44,107,145,2,"https://fbref.com/en/players/30d4a2e5/Vitaliy-Mykolenko"
2025,"Everton","Premier League","Iliman Ndiaye","SEN","FW","25-082",2000,27,53,28,20,16,17,22,49,44.9,27,30,5,25,20,73,24,1,"https://fbref.com/en/players/5ed97752/Iliman-Ndiaye"
2025,"Everton","Premier League","Jake O'Brien","IRL","DF","24-012",2001,17.5,26,17,21,5,0,17,25,68,8,17,4,13,4,30,93,0,"https://fbref.com/en/players/25f2ef01/Jake-OBrien"
2025,"Everton","Premier League","Nathan Patterson","SCO","DF","23-223",2001,3.9,11,6,7,4,0,7,14,50,7,2,0,2,2,13,7,0,"https://fbref.com/en/players/230f0471/Nathan-Patterson"
2025,"Everton","Premier League","Jordan Pickford","ENG","GK","31-081",1994,38,1,0,1,0,0,1,2,50,1,0,0,0,1,2,30,2,"https://fbref.com/en/players/4806ec67/Jordan-Pickford"
2025,"Everton","Premier League","James Tarkowski","ENG","DF","32-189",1992,32.5,64,40,39,22,3,24,39,61.5,15,57,42,15,41,105,213,4,"https://fbref.com/en/players/15ea812b/James-Tarkowski"
2025,"Everton","Premier League","Ashley Young","ENG","DF","39-322",1985,20.8,58,33,25,25,8,35,57,61.4,22,14,4,10,25,83,64,2,"https://fbref.com/en/players/be927d03/Ashley-Young"
2025,"Fiorentina","Serie A","Yacine Adli","FRA","MF","24-302",2000,13.7,32,19,11,16,5,17,39,43.6,22,13,1,12,6,38,19,0,"https://fbref.com/en/players/26777636/Yacine-Adli"
2025,"Fiorentina","Serie A","Sofyan Amrabat","MAR","MF","28-279",1996,2,3,2,1,2,0,2,2,100,0,1,1,0,0,3,2,0,"https://fbref.com/en/players/5a2cb25d/Sofyan-Amrabat"
2025,"Fiorentina","Serie A","Antonín Barák","CZE","MF","30-175",1994,0.6,2,0,0,2,0,0,2,0,2,1,1,0,0,2,0,0,"https://fbref.com/en/players/01efac19/Antonin-Barak"
2025,"Fiorentina","Serie A","Lucas Beltrán","ARG","FW,MF","24-059",2001,21.7,23,10,10,7,6,7,21,33.3,14,15,2,13,5,28,14,0,"https://fbref.com/en/players/482d2bc3/Lucas-Beltran"
2025,"Fiorentina","Serie A","Alessandro Bianco","ITA","MF","22-238",2002,0.2,0,0,0,0,0,0,1,0,1,0,0,0,0,0,0,0,"https://fbref.com/en/players/d65cf468/Alessandro-Bianco"
2025,"Fiorentina","Serie A","Cristiano Biraghi","ITA","DF","32-268",1992,4.8,4,4,1,3,0,2,7,28.6,5,2,0,2,4,8,11,0,"https://fbref.com/en/players/9e1577aa/Cristiano-Biraghi"
2025,"Fiorentina","Serie A","Edoardo Bove","ITA","MF,FW","23-011",2002,9.5,24,17,7,14,3,14,28,50,14,12,0,12,6,30,8,0,"https://fbref.com/en/players/ae94a6c5/Edoardo-Bove"
2025,"Fiorentina","Serie A","Danilo Cataldi","ITA","MF","30-294",1994,19.2,25,16,13,10,2,14,27,51.9,13,17,8,9,22,47,35,0,"https://fbref.com/en/players/ba3d3bea/Danilo-Cataldi"
2025,"Fiorentina","Serie A","Andrea Colpani","ITA","FW,MF","26-016",1999,16.1,15,9,5,7,3,4,12,33.3,8,7,0,7,9,24,10,0,"https://fbref.com/en/players/6499048c/Andrea-Colpani"
2025,"Fiorentina","Serie A","Pietro Comuzzo","ITA","DF","20-096",2005,24.4,43,21,29,11,3,23,29,79.3,6,35,22,13,29,72,113,4,"https://fbref.com/en/players/5e3ecc35/Pietro-Comuzzo"
2025,"Fiorentina","Serie A","Maat Daniel Caprini","ITA","FW","19-105",2006,0.1,0,0,0,0,0,0,0,NA,0,0,0,0,0,0,0,0,"https://fbref.com/en/players/183934cd/Maat-Daniel-Caprini"
2025,"Fiorentina","Serie A","Dodô","BRA","DF","26-191",1998,34.6,44,30,25,11,8,25,49,51,24,22,5,17,35,79,58,2,"https://fbref.com/en/players/b5f7d10b/Dodo"
2025,"Fiorentina","Serie A","Nicolò Fagioli","ITA","MF","24-104",2001,10.7,19,10,8,9,2,9,22,40.9,13,11,2,9,5,24,12,2,"https://fbref.com/en/players/366be751/Nicolo-Fagioli"
2025,"Fiorentina","Serie A","Michael Folorunsho","ITA","FW,MF","27-109",1998,7.2,19,12,9,6,4,8,20,40,12,9,1,8,4,23,10,0,"https://fbref.com/en/players/c391a179/Michael-Folorunsho"
2025,"Fiorentina","Serie A","David de Gea","ESP","GK","34-201",1990,35,1,0,1,0,0,1,1,100,0,0,0,0,0,1,12,0,"https://fbref.com/en/players/7ba6d84e/David-de-Gea"
2025,"Fiorentina","Serie A","Robin Gosens","GER","DF","30-326",1994,28,56,32,31,17,8,25,44,56.8,19,34,11,23,18,74,91,0,"https://fbref.com/en/players/2d970560/Robin-Gosens"
2025,"Fiorentina","Serie A","Albert Guðmundsson","ISL","FW,MF","27-346",1997,14.1,9,5,2,4,3,7,17,41.2,10,5,0,5,6,15,9,1,"https://fbref.com/en/players/b79858d5/Albert-Gudmundsson"
2025,"Fiorentina","Serie A","Jonathan Ikone","FRA","FW,MF","27-025",1998,3.7,5,2,3,2,0,2,4,50,2,3,0,3,1,6,1,0,"https://fbref.com/en/players/42eaa028/Jonathan-Ikone"
2025,"Fiorentina","Serie A","Michael Kayode","ITA","DF,FW","20-321",2004,1.4,1,1,1,0,0,0,0,NA,0,3,1,2,2,3,7,0,"https://fbref.com/en/players/e19660a8/Michael-Kayode"
2025,"Fiorentina","Serie A","Moise Kean","ITA","FW","25-088",2000,30,7,5,1,2,4,3,4,75,1,12,0,12,6,13,26,1,"https://fbref.com/en/players/3d50bcdb/Moise-Kean"
2025,"Fiorentina","Serie A","Christian Kouamé","CIV","FW,MF","27-172",1997,6.9,13,8,4,4,5,0,3,0,3,3,1,2,2,15,10,0,"https://fbref.com/en/players/58e933d2/Christian-Kouame"
2025,"Fiorentina","Serie A","Rolando Mandragora","ITA","MF","27-332",1997,21.5,23,13,9,12,2,14,31,45.2,17,22,7,15,17,40,54,1,"https://fbref.com/en/players/c7259b83/Rolando-Mandragora"
2025,"Fiorentina","Serie A","Pablo Marí","ESP","DF","31-269",1993,12.2,14,9,11,3,0,6,11,54.5,5,19,14,5,25,39,94,0,"https://fbref.com/en/players/aa54ec6f/Pablo-Mari"
2025,"Fiorentina","Serie A","Lucas Martínez Quarta","ARG","DF","29-017",1996,3.9,12,7,9,3,0,8,13,61.5,5,5,2,3,3,15,25,1,"https://fbref.com/en/players/3ec3c1c9/Lucas-Martinez-Quarta"
2025,"Fiorentina","Serie A","Matias Moreno","ARG","DF","21-245",2003,1.6,8,8,5,3,0,4,4,100,0,5,1,4,1,9,9,0,"https://fbref.com/en/players/4637e608/Matias-Moreno"
2025,"Fiorentina","Serie A","Cher Ndour","ITA","MF,DF","20-304",2004,4.5,4,1,2,1,1,2,10,20,8,5,1,4,2,6,7,1,"https://fbref.com/en/players/3b88609d/Cher-Ndour"
2025,"Fiorentina","Serie A","Fabiano Parisi","ITA","DF,MF","24-199",2000,12.5,27,17,11,12,4,12,21,57.1,9,14,2,12,17,44,17,0,"https://fbref.com/en/players/0967845b/Fabiano-Parisi"
2025,"Fiorentina","Serie A","Marin Pongračić","CRO","DF","27-258",1997,15.2,18,13,13,4,1,7,11,63.6,4,14,6,8,12,30,69,2,"https://fbref.com/en/players/2a6cd437/Marin-Pongracic"
2025,"Fiorentina","Serie A","Luca Ranieri","ITA","DF","26-034",1999,34.1,42,24,28,12,2,20,25,80,5,47,32,15,28,70,154,1,"https://fbref.com/en/players/8c63fae5/Luca-Ranieri"
2025,"Fiorentina","Serie A","Amir Richardson","MAR","MF","23-123",2002,12.2,30,13,13,15,2,9,21,42.9,12,14,1,13,6,36,29,1,"https://fbref.com/en/players/2b7cdb79/Amir-Richardson"
2025,"Fiorentina","Serie A","Tommaso Rubino","ITA","MF","18-198",2006,0.1,0,0,0,0,0,0,1,0,1,0,0,0,0,0,0,0,"https://fbref.com/en/players/cf5bf6c7/Tommaso-Rubino"
2025,"Fiorentina","Serie A","Riccardo Sottil","ITA","FW,MF","25-358",1999,9.3,5,4,3,1,1,3,4,75,1,1,0,1,4,9,3,0,"https://fbref.com/en/players/94816803/Riccardo-Sottil"
2025,"Fiorentina","Serie A","Pietro Terracciano","ITA","GK","35-080",1990,3,0,0,0,0,0,0,0,NA,0,0,0,0,0,0,0,0,"https://fbref.com/en/players/e1b0a70d/Pietro-Terracciano"
2025,"Fiorentina","Serie A","Nicolò Zaniolo","ITA","FW","25-329",1999,3.8,3,1,1,2,0,0,4,0,4,2,1,1,0,3,2,0,"https://fbref.com/en/players/9907b1c8/Nicolo-Zaniolo"
2025,"Freiburg","Bundesliga","Junior Adamu","AUT","FW","23-355",2001,17.2,9,3,3,3,3,3,11,27.3,8,14,0,14,12,21,20,0,"https://fbref.com/en/players/82e12fe7/Junior-Adamu"
2025,"Freiburg","Bundesliga","Noah Atubolu","GER","GK","23-002",2002,25.6,0,0,0,0,0,0,0,NA,0,0,0,0,0,0,13,4,"https://fbref.com/en/players/dbd1b101/Noah-Atubolu"
2025,"Freiburg","Bundesliga","Jan-Niklas Beste","GER","FW,MF","26-143",1999,2.4,2,1,0,1,1,1,7,14.3,6,3,0,3,1,3,7,0,"https://fbref.com/en/players/57382429/Jan-Niklas-Beste"
2025,"Freiburg","Bundesliga","Eren Dinkçi","GER","MF,FW","23-165",2001,13.3,21,13,8,8,5,7,23,30.4,16,22,2,20,7,28,7,0,"https://fbref.com/en/players/4ccd8957/Eren-Dinkci"
2025,"Freiburg","Bundesliga","Ritsu Doan","JPN","FW,MF","26-345",1998,31.8,66,42,33,26,7,25,46,54.3,21,57,2,55,14,80,47,1,"https://fbref.com/en/players/d01bbb6f/Ritsu-Doan"
2025,"Freiburg","Bundesliga","Maximilian Eggestein","GER","MF","28-170",1996,31.6,57,32,21,26,10,24,43,55.8,19,37,10,27,39,96,54,1,"https://fbref.com/en/players/beb882a8/Maximilian-Eggestein"
2025,"Freiburg","Bundesliga","Matthias Ginter","GER","DF","31-128",1994,28.5,30,17,15,11,4,15,28,53.6,13,35,23,12,19,49,146,5,"https://fbref.com/en/players/f521b80a/Matthias-Ginter"
2025,"Freiburg","Bundesliga","Michael Gregoritsch","AUT","FW","31-039",1994,7.1,4,2,1,0,3,1,5,20,4,2,1,1,1,5,10,0,"https://fbref.com/en/players/8e235926/Michael-Gregoritsch"
2025,"Freiburg","Bundesliga","Vincenzo Grifo","ITA","FW,MF","32-050",1993,27,30,22,12,13,5,15,34,44.1,19,24,2,22,9,39,23,2,"https://fbref.com/en/players/54e4866f/Vincenzo-Grifo"
2025,"Freiburg","Bundesliga","Christian Günter","GER","DF","32-088",1993,25.7,23,21,12,8,3,16,29,55.2,13,24,10,14,8,31,50,1,"https://fbref.com/en/players/8593f88c/Christian-Gunter"
2025,"Freiburg","Bundesliga","Nicolas Höfler","GER","MF","35-079",1990,8.8,33,23,13,18,2,20,31,64.5,11,7,1,6,14,47,28,1,"https://fbref.com/en/players/5d8e331f/Nicolas-Hofler"
2025,"Freiburg","Bundesliga","Lucas Höler","GER","FW,MF","30-321",1994,20.7,37,24,18,15,4,9,24,37.5,15,29,7,22,7,44,36,0,"https://fbref.com/en/players/ca618d23/Lucas-Holer"
2025,"Freiburg","Bundesliga","Lukas Kübler","GER","DF","32-270",1992,20.5,40,21,17,20,3,27,48,56.3,21,32,13,19,53,93,61,3,"https://fbref.com/en/players/2a29eb9b/Lukas-Kubler"
2025,"Freiburg","Bundesliga","Philipp Lienhart","AUT","DF","28-320",1996,30.8,22,13,12,10,0,15,31,48.4,16,31,20,11,36,58,124,3,"https://fbref.com/en/players/302527b2/Philipp-Lienhart"
2025,"Freiburg","Bundesliga","Jordy Makengo","FRA","DF","23-297",2001,8.3,16,9,10,5,1,10,16,62.5,6,8,3,5,7,23,29,0,"https://fbref.com/en/players/14b09c41/Jordy-Makengo"
2025,"Freiburg","Bundesliga","Johan Manzambi","SUI","FW,MF","19-225",2005,3.7,8,2,1,3,4,1,4,25,3,6,0,6,4,12,7,0,"https://fbref.com/en/players/8fcf0e12/Johan-Manzambi"
2025,"Freiburg","Bundesliga","Florian Müller","GER","GK","27-195",1997,8.4,0,0,0,0,0,0,0,NA,0,0,0,0,0,0,3,0,"https://fbref.com/en/players/cbac6ec9/Florian-Muller"
2025,"Freiburg","Bundesliga","Florent Muslija","KVX","FW,MF","26-325",1998,1.9,5,4,3,1,1,2,2,100,0,0,0,0,1,6,1,0,"https://fbref.com/en/players/ae961785/Florent-Muslija"
2025,"Freiburg","Bundesliga","Ifechukwu Ogbus","SUI","DF","19-161",2005,0.2,1,1,0,0,1,0,1,0,1,0,0,0,1,2,2,0,"https://fbref.com/en/players/d41472b7/Ifechukwu-Ogbus"
2025,"Freiburg","Bundesliga","Patrick Osterhage","GER","MF","25-115",2000,25.2,45,29,16,27,2,14,30,46.7,16,27,3,24,18,63,37,0,"https://fbref.com/en/players/9662c9ec/Patrick-Osterhage"
2025,"Freiburg","Bundesliga","Maximilian Philipp","GER","MF,FW","31-087",1994,0.2,0,0,0,0,0,0,0,NA,0,0,0,0,0,0,0,0,"https://fbref.com/en/players/061e8e23/Maximilian-Philipp"
2025,"Freiburg","Bundesliga","Merlin Röhl","GER","MF,FW","22-326",2002,10.7,16,10,4,10,2,9,11,81.8,2,9,1,8,6,22,2,0,"https://fbref.com/en/players/1f2c7b55/Merlin-Rohl"
2025,"Freiburg","Bundesliga","Max Rosenfelder","GER","DF","22-106",2003,13.9,27,17,17,10,0,14,19,73.7,5,17,9,8,7,34,65,0,"https://fbref.com/en/players/b6ceba6b/Max-Rosenfelder"
2025,"Freiburg","Bundesliga","Roland Sallai","HUN","FW,MF","28-005",1997,0.5,2,1,1,1,0,0,0,NA,0,0,0,0,1,3,0,0,"https://fbref.com/en/players/bf075f6b/Roland-Sallai"
2025,"Freiburg","Bundesliga","Kiliann Sildillia","FRA","DF","23-011",2002,8.9,17,10,8,6,3,7,13,53.8,6,16,5,11,11,28,38,0,"https://fbref.com/en/players/313254a3/Kiliann-Sildillia"
2025,"Freiburg","Bundesliga","Noah Weißhaupt","GER","FW","23-249",2001,0.9,0,0,0,0,0,0,1,0,1,0,0,0,0,0,1,0,"https://fbref.com/en/players/dd676a97/Noah-Weisshaupt"
2025,"Fulham","Premier League","Joachim Andersen","DEN","DF","28-361",1996,28.7,27,18,20,6,1,15,24,62.5,9,37,28,9,34,61,188,1,"https://fbref.com/en/players/e34fc66d/Joachim-Andersen"
2025,"Fulham","Premier League","Calvin Bassey","NGA","DF","25-147",1999,34.2,54,34,35,19,0,22,31,71,9,40,17,23,20,74,118,8,"https://fbref.com/en/players/a36524bf/Calvin-Bassey"
2025,"Fulham","Premier League","Sander Berge","NOR","MF","27-102",1998,24.7,50,30,23,23,4,27,39,69.2,12,27,8,19,21,71,38,1,"https://fbref.com/en/players/d0b6129f/Sander-Berge"
2025,"Fulham","Premier League","Tom Cairney","SCO","MF","34-127",1991,7,13,5,5,2,6,4,7,57.1,3,7,1,6,4,17,3,1,"https://fbref.com/en/players/a8748947/Tom-Cairney"
2025,"Fulham","Premier League","Timothy Castagne","BEL","DF","29-173",1995,18.3,46,29,28,15,3,26,45,57.8,19,15,6,9,22,68,83,0,"https://fbref.com/en/players/197640fd/Timothy-Castagne"
2025,"Fulham","Premier League","Jorge Cuenca","ESP","DF","25-191",1999,3.9,6,2,5,1,0,3,8,37.5,5,4,4,0,2,8,26,0,"https://fbref.com/en/players/0abc51f2/Jorge-Cuenca"
2025,"Fulham","Premier League","Issa Diop","FRA","DF","28-138",1997,14.9,26,12,18,8,0,13,18,72.2,5,10,7,3,9,35,72,2,"https://fbref.com/en/players/a712ca2b/Issa-Diop"
2025,"Fulham","Premier League","Martial Godo","ENG","FW,DF","22-074",2003,0.3,0,0,0,0,0,0,0,NA,0,1,0,1,1,1,0,0,"https://fbref.com/en/players/e0eea46f/Martial-Godo"
2025,"Fulham","Premier League","Alex Iwobi","NGA","FW,MF","29-024",1996,33.1,44,25,14,21,9,22,34,64.7,12,26,1,25,14,58,29,1,"https://fbref.com/en/players/6ca5ec4b/Alex-Iwobi"
2025,"Fulham","Premier League","Raúl Jiménez","MEX","FW","34-022",1991,27.7,35,24,9,17,9,8,22,36.4,14,21,5,16,10,45,23,3,"https://fbref.com/en/players/b561db50/Raul-Jimenez"
2025,"Fulham","Premier League","Joshua King","ENG","MF","18-144",2007,1.5,7,5,3,4,0,0,3,0,3,3,0,3,1,8,1,0,"https://fbref.com/en/players/86109b3b/Joshua-King"
2025,"Fulham","Premier League","Bernd Leno","GER","GK","33-084",1992,38,2,2,2,0,0,2,2,100,0,1,0,1,0,2,11,5,"https://fbref.com/en/players/2628fd2b/Bernd-Leno"
2025,"Fulham","Premier League","Saša Lukić","SRB","MF","28-287",1996,26,68,39,22,40,6,23,55,41.8,32,20,7,13,28,96,35,1,"https://fbref.com/en/players/c6e8cf1f/Sasa-Lukic"
2025,"Fulham","Premier League","Rodrigo Muniz","BRA","FW","24-023",2001,10.7,10,5,3,5,2,4,4,100,0,9,2,7,5,15,14,0,"https://fbref.com/en/players/a755db8c/Rodrigo-Muniz"
2025,"Fulham","Premier League","Reiss Nelson","ENG","FW","25-168",1999,5.4,8,6,3,3,2,5,13,38.5,8,11,0,11,5,13,2,0,"https://fbref.com/en/players/c5bdb6e3/Reiss-Nelson"
2025,"Fulham","Premier League","Andreas Pereira","BRA","MF","29-146",1996,22.4,24,13,8,11,5,10,42,23.8,32,17,2,15,8,32,17,3,"https://fbref.com/en/players/6639e500/Andreas-Pereira"
2025,"Fulham","Premier League","Harrison Reed","ENG","MF","30-120",1995,1.2,6,3,3,2,1,1,3,33.3,2,1,0,1,1,7,3,0,"https://fbref.com/en/players/803ae100/Harrison-Reed"
2025,"Fulham","Premier League","Antonee Robinson","USA","DF","27-292",1997,35.2,95,61,57,31,7,45,95,47.4,50,43,9,34,62,157,133,2,"https://fbref.com/en/players/289601e6/Antonee-Robinson"
2025,"Fulham","Premier League","Ryan Sessegnon","ENG","FW,DF","25-009",2000,6.4,27,13,11,11,5,9,20,45,11,13,1,12,3,30,18,0,"https://fbref.com/en/players/6aa3e78b/Ryan-Sessegnon"
2025,"Fulham","Premier League","Emile Smith Rowe","ENG","MF","24-303",2000,22.7,31,18,7,14,10,8,24,33.3,16,22,2,20,11,42,16,0,"https://fbref.com/en/players/17695062/Emile-Smith-Rowe"
2025,"Fulham","Premier League","Jay Stansfield","ENG","MF","22-184",2002,0,0,0,0,0,0,0,0,NA,0,0,0,0,0,0,0,0,"https://fbref.com/en/players/b2626673/Jay-Stansfield"
2025,"Fulham","Premier League","Kenny Tete","NED","DF","29-230",1995,19.7,56,38,29,14,13,23,38,60.5,15,31,12,19,32,88,67,0,"https://fbref.com/en/players/77d7c96f/Kenny-Tete"
2025,"Fulham","Premier League","Adama Traoré","ESP","FW,MF","29-122",1996,19.7,20,13,9,6,5,5,13,38.5,8,7,0,7,1,21,6,4,"https://fbref.com/en/players/9a28eba4/Adama-Traore"
2025,"Fulham","Premier League","Carlos Vinícius","BRA","MF,FW","30-063",1995,0.2,0,0,0,0,0,0,1,0,1,1,0,1,0,0,0,0,"https://fbref.com/en/players/8b529245/Carlos-Vinicius"
2025,"Fulham","Premier League","Willian","BRA","FW,MF","36-291",1988,2.9,4,2,0,3,1,2,6,33.3,4,0,0,0,1,5,1,0,"https://fbref.com/en/players/8b9ebd03/Willian"
2025,"Fulham","Premier League","Harry Wilson","WAL","FW,MF","28-066",1997,12.9,20,14,13,3,4,12,18,66.7,6,15,1,14,7,27,10,1,"https://fbref.com/en/players/c6dc9ecd/Harry-Wilson"
2025,"Genoa","Serie A","Federico Accornero","ITA","MF","21-111",2004,0.1,0,0,0,0,0,0,0,NA,0,0,0,0,0,0,0,0,"https://fbref.com/en/players/83763653/Federico-Accornero"
2025,"Genoa","Serie A","Honest Ahanor","ITA","DF,MF","17-093",2008,3,7,5,2,3,2,7,10,70,3,4,0,4,1,8,9,0,"https://fbref.com/en/players/42ff58c3/Honest-Ahanor"
2025,"Genoa","Serie A","David Akpan Ankeye","NGA","FW,MF","23-102",2002,0.5,0,0,0,0,0,0,1,0,1,0,0,0,0,0,1,0,"https://fbref.com/en/players/8c4b95af/David-Akpan-Ankeye"
2025,"Genoa","Serie A","Milan Badelj","CRO","MF","36-091",1989,16.4,29,16,14,10,5,15,35,42.9,20,19,7,12,20,49,43,0,"https://fbref.com/en/players/e8c930bb/Milan-Badelj"
2025,"Genoa","Serie A","Mario Balotelli","ITA","FW,MF","34-288",1990,0.7,0,0,0,0,0,0,0,NA,0,0,0,0,0,0,1,0,"https://fbref.com/en/players/8ff07990/Mario-Balotelli"
2025,"Genoa","Serie A","Mattia Bani","ITA","DF","31-168",1993,16.7,19,10,11,6,2,7,11,63.6,4,13,8,5,22,41,85,2,"https://fbref.com/en/players/0821331c/Mattia-Bani"
2025,"Genoa","Serie A","Emil Bohinen","NOR","MF","26-076",1999,1.8,4,4,3,0,1,2,5,40,3,2,0,2,1,5,6,0,"https://fbref.com/en/players/c83c203f/Emil-Bohinen"
2025,"Genoa","Serie A","Maxwel Cornet","CIV","FW,MF","28-242",1996,2.7,2,1,1,0,1,0,1,0,1,1,1,0,2,4,2,0,"https://fbref.com/en/players/beb391dd/Maxwel-Cornet"
2025,"Genoa","Serie A","Koni De Winter","BEL","DF","22-349",2002,23.7,33,19,21,8,4,17,25,68,8,11,7,4,25,58,118,3,"https://fbref.com/en/players/f4797849/Koni-De-Winter"
2025,"Genoa","Serie A","Jeff Ekhator","ITA","FW,MF","18-197",2006,8.5,7,4,4,1,2,4,9,44.4,5,10,1,9,2,9,5,0,"https://fbref.com/en/players/faf739d2/Jeff-Ekhator"
2025,"Genoa","Serie A","Caleb Ekuban","GHA","FW","31-065",1994,6.2,3,3,1,1,1,1,1,100,0,4,1,3,1,4,6,0,"https://fbref.com/en/players/7afbd2c3/Caleb-Ekuban"
2025,"Genoa","Serie A","Morten Frendrup","DEN","MF","24-050",2001,34.5,102,61,23,52,27,34,78,43.6,44,62,16,46,47,149,57,0,"https://fbref.com/en/players/f4d60499/Morten-Frendrup"
2025,"Genoa","Serie A","Pierluigi Gollini","ITA","GK","30-070",1995,7,0,0,0,0,0,0,0,NA,0,1,0,1,0,0,2,1,"https://fbref.com/en/players/f0f7f62f/Pierluigi-Gollini"
2025,"Genoa","Serie A","Lior Kasa","ISR","MF,FW","19-242",2005,2.6,4,4,2,2,0,2,5,40,3,4,1,3,3,7,5,0,"https://fbref.com/en/players/7987ef17/Lior-Kasa"
2025,"Genoa","Serie A","Nicola Leali","ITA","GK","32-099",1993,29,0,0,0,0,0,0,0,NA,0,0,0,0,0,0,14,1,"https://fbref.com/en/players/5f9970a0/Nicola-Leali"
2025,"Genoa","Serie A","Ruslan Malinovskyi","UKR","MF,FW","32-023",1993,4.3,12,8,4,7,1,3,6,50,3,2,0,2,1,13,4,0,"https://fbref.com/en/players/48d5bd33/Ruslan-Malinovskyi"
2025,"Genoa","Serie A","Alessandro Marcandalli","ITA","DF","22-244",2002,0.5,1,0,1,0,0,0,0,NA,0,0,0,0,0,1,2,0,"https://fbref.com/en/players/d3225ad1/Alessandro-Marcandalli"
2025,"Genoa","Serie A","Aarón Martín","ESP","DF","28-035",1997,34.3,71,47,41,26,4,33,51,64.7,18,33,11,22,19,90,73,1,"https://fbref.com/en/players/2f3e911a/Aaron-Martin"
2025,"Genoa","Serie A","Patrizio Masini","ITA","MF","24-120",2001,17.1,54,29,18,26,10,19,40,47.5,21,26,8,18,15,69,37,0,"https://fbref.com/en/players/151354b8/Patrizio-Masini"
2025,"Genoa","Serie A","Alan Matturro","URU","DF","20-228",2004,10,11,6,6,5,0,3,14,21.4,11,10,3,7,14,25,38,0,"https://fbref.com/en/players/547c0119/Alan-Matturro"
2025,"Genoa","Serie A","Filippo Melegoni","ITA","MF,FW","26-098",1999,1,1,1,1,0,0,0,4,0,4,0,0,0,0,1,2,0,"https://fbref.com/en/players/6604165d/Filippo-Melegoni"
2025,"Genoa","Serie A","Junior Messias","BRA","MF,FW","34-014",1991,9.4,13,7,6,6,1,3,10,30,7,8,2,6,6,19,20,0,"https://fbref.com/en/players/f49c4ae9/Junior-Messias"
2025,"Genoa","Serie A","Fabio Miretti","ITA","MF,FW","21-297",2003,18.6,28,15,6,14,8,18,33,54.5,15,20,1,19,7,35,13,2,"https://fbref.com/en/players/34693494/Fabio-Miretti"
2025,"Genoa","Serie A","Brooke Norton-Cuffy","ENG","DF,FW","21-135",2004,8,12,7,9,3,0,9,11,81.8,2,12,2,10,3,15,12,0,"https://fbref.com/en/players/54f5b2bd/Brooke-Norton-Cuffy"
2025,"Genoa","Serie A","Jean Onana","CMR","MF","25-139",2000,3.4,12,6,2,10,0,5,9,55.6,4,6,1,5,4,16,8,1,"https://fbref.com/en/players/b5bb8188/Jean-Onana"
2025,"Genoa","Serie A","Sebastian Otoa","DEN","DF","21-014",2004,2,1,0,1,0,0,1,2,50,1,1,1,0,3,4,14,0,"https://fbref.com/en/players/a214da59/Sebastian-Otoa"
2025,"Genoa","Serie A","Gastón Pereiro","URU","MF","29-350",1995,0.3,1,0,0,1,0,1,1,100,0,0,0,0,0,1,1,0,"https://fbref.com/en/players/7ec7738e/Gaston-Pereiro"
2025,"Genoa","Serie A","Andrea Pinamonti","ITA","FW","26-008",1999,31.7,10,6,0,7,3,2,8,25,6,16,4,12,1,11,28,2,"https://fbref.com/en/players/08aa9cd1/Andrea-Pinamonti"
2025,"Genoa","Serie A","Stefano Sabelli","ITA","DF","32-134",1993,22.9,58,31,27,25,6,20,52,38.5,32,28,7,21,22,80,65,0,"https://fbref.com/en/players/0ccac09c/Stefano-Sabelli"
2025,"Genoa","Serie A","Benjamin Siegrist","SUI","GK","33-116",1992,1.7,0,0,0,0,0,0,0,NA,0,0,0,0,1,1,1,0,"https://fbref.com/en/players/46912ffe/Benjamin-Siegrist"
2025,"Genoa","Serie A","Daniele Sommariva","ITA","GK","27-313",1997,0.3,0,0,0,0,0,0,0,NA,0,0,0,0,0,0,1,0,"https://fbref.com/en/players/a8e7f7e9/Daniele-Sommariva"
2025,"Genoa","Serie A","Morten Thorsby","NOR","MF,FW","29-022",1996,21.1,49,30,19,20,10,17,29,58.6,12,22,1,21,5,54,28,1,"https://fbref.com/en/players/d1b49282/Morten-Thorsby"
2025,"Genoa","Serie A","Johan Vásquez","MEX","DF","26-217",1998,33.8,56,31,24,27,5,26,44,59.1,18,59,31,28,50,106,150,1,"https://fbref.com/en/players/5eaed77a/Johan-Vasquez"
2025,"Genoa","Serie A","Lorenzo Venturino","ITA","FW,MF","18-339",2006,1.9,5,3,4,0,1,3,6,50,3,3,0,3,0,5,5,0,"https://fbref.com/en/players/a5049464/Lorenzo-Venturino"
2025,"Genoa","Serie A","Vitinha","POR","FW,MF","25-073",2000,14.8,23,8,12,6,5,11,30,36.7,19,14,2,12,12,35,22,0,"https://fbref.com/en/players/74d4cec6/Vitinha"
2025,"Genoa","Serie A","Alessandro Vogliacco","ITA","DF","26-255",1998,7.9,15,3,7,7,1,10,12,83.3,2,11,7,4,9,24,20,0,"https://fbref.com/en/players/6841f107/Alessandro-Vogliacco"
2025,"Genoa","Serie A","Alessandro Zanoli","ITA","FW,DF","24-236",2000,19,29,20,11,14,4,10,23,43.5,13,20,3,17,12,41,40,0,"https://fbref.com/en/players/3b12b11f/Alessandro-Zanoli"
2025,"Getafe","La Liga","Nabil Aberdin","FRA","MF","22-277",2002,2.9,6,4,3,3,0,1,1,100,0,3,0,3,0,6,5,0,"https://fbref.com/en/players/cadfa7d1/Nabil-Aberdin"
2025,"Getafe","La Liga","Omar Alderete","PAR","DF","28-152",1996,33,43,29,30,11,2,20,30,66.7,10,38,22,16,40,83,241,1,"https://fbref.com/en/players/bb08bce9/Omar-Alderete"
2025,"Getafe","La Liga","Carles Aleñá","ESP","MF,FW","27-142",1998,5,6,3,2,3,1,4,13,30.8,9,9,1,8,0,6,7,0,"https://fbref.com/en/players/6c811eb7/Carles-Alena"
2025,"Getafe","La Liga","Mauro Arambarri","URU","MF","29-239",1995,29.6,48,29,10,33,5,22,48,45.8,26,35,6,29,15,63,46,0,"https://fbref.com/en/players/58afe001/Mauro-Arambarri"
2025,"Getafe","La Liga","David Argüelles","ESP","MF","23-146",2002,0.1,0,0,0,0,0,0,0,NA,0,2,0,2,0,0,0,0,"https://fbref.com/en/players/a1b81f14/David-Arguelles"
2025,"Getafe","La Liga","Ismael Bekhoucha","MAR","MF,DF","20-188",2004,0.8,1,1,1,0,0,1,2,50,1,2,1,1,2,3,2,0,"https://fbref.com/en/players/e42c0f53/Ismael-Bekhoucha"
2025,"Getafe","La Liga","Juan Bernat","ESP","MF,DF","32-087",1993,7.8,19,13,9,5,5,7,12,58.3,5,9,3,6,2,21,12,0,"https://fbref.com/en/players/433dc9a2/Juan-Bernat"
2025,"Getafe","La Liga","Juan Berrocal","ESP","DF","26-023",1999,11.8,14,7,10,4,0,10,14,71.4,4,6,3,3,15,29,59,0,"https://fbref.com/en/players/377ef3a6/Juan-Berrocal"
2025,"Getafe","La Liga","Coba da Costa","ESP","MF,FW","22-305",2002,11.2,29,13,9,16,4,13,26,50,13,24,0,24,8,37,10,0,"https://fbref.com/en/players/0b3358f0/Coba-da-Costa"
2025,"Getafe","La Liga","Djené","TOG","DF,MF","33-147",1991,28.3,25,13,12,11,2,12,32,37.5,20,18,8,10,21,46,107,3,"https://fbref.com/en/players/a4971d84/Djene"
2025,"Getafe","La Liga","Domingos Duarte","POR","DF","30-078",1995,20.7,28,15,22,4,2,17,21,81,4,28,16,12,18,46,152,1,"https://fbref.com/en/players/93090f69/Domingos-Duarte"
2025,"Getafe","La Liga","Peter González","DOM","MF,FW","22-306",2002,5.3,11,6,2,5,4,6,9,66.7,3,8,0,8,2,13,5,0,"https://fbref.com/en/players/1ccd3dae/Peter-Gonzalez"
2025,"Getafe","La Liga","Iglesias","ESP","DF","26-328",1998,32.1,81,47,42,33,6,46,90,51.1,44,47,8,39,50,131,133,1,"https://fbref.com/en/players/974322dc/Iglesias"
2025,"Getafe","La Liga","John Joe","IRL","MF,FW","21-215",2003,0.5,0,0,0,0,0,0,0,NA,0,1,1,0,0,0,1,0,"https://fbref.com/en/players/fd01216a/John-Joe"
2025,"Getafe","La Liga","Juanmi","ESP","FW,MF","32-007",1993,7.7,14,11,4,7,3,6,19,31.6,13,6,0,6,2,16,3,0,"https://fbref.com/en/players/84399660/Juanmi"
2025,"Getafe","La Liga","Abdoulaye Keita","ESP","FW,MF","22-268",2002,1.1,2,2,0,1,1,2,4,50,2,1,0,1,0,2,3,0,"https://fbref.com/en/players/154b6735/Abdoulaye-Keita"
2025,"Getafe","La Liga","Borja Mayoral","ESP","FW","28-052",1997,12.4,5,4,2,2,1,3,9,33.3,6,4,0,4,2,7,6,0,"https://fbref.com/en/players/64e8ed6d/Borja-Mayoral"
2025,"Getafe","La Liga","Luis Milla","ESP","MF","30-232",1994,31.9,61,40,28,25,8,35,72,48.6,37,25,0,25,24,85,28,3,"https://fbref.com/en/players/19c36442/Luis-Milla"
2025,"Getafe","La Liga","Allan Nyom","CMR","DF,MF","37-017",1988,9.9,18,11,7,9,2,15,17,88.2,2,4,2,2,4,22,23,0,"https://fbref.com/en/players/97572117/Allan-Nyom"
2025,"Getafe","La Liga","Carles Pérez","ESP","MF,FW","27-100",1998,15.9,33,23,11,14,8,21,48,43.8,27,19,2,17,6,39,22,0,"https://fbref.com/en/players/a8f21b9f/Carles-Perez"
2025,"Getafe","La Liga","Diego Rico","ESP","DF","32-093",1993,31.3,81,49,47,29,5,47,85,55.3,38,41,3,38,34,115,102,2,"https://fbref.com/en/players/d9ba39fc/Diego-Rico"
2025,"Getafe","La Liga","Alberto Risco","ESP","MF,FW","19-270",2005,0.8,4,4,2,0,2,1,6,16.7,5,2,0,2,0,4,0,0,"https://fbref.com/en/players/36286814/Alberto-Risco"
2025,"Getafe","La Liga","Gorka Rivera Alonso","ESP","DF,MF","20-299",2004,0.2,2,0,0,2,0,2,2,100,0,0,0,0,0,2,0,0,"https://fbref.com/en/players/f1124008/Gorka-Rivera-Alonso"
2025,"Getafe","La Liga","Álvaro Rodríguez","URU","FW","20-317",2004,9.5,10,7,0,7,3,5,10,50,5,23,0,23,3,13,12,0,"https://fbref.com/en/players/49a6ecbb/Alvaro-Rodriguez"
2025,"Getafe","La Liga","Jesús Santiago","ESP","MF","21-002",2004,4.1,14,8,6,8,0,5,10,50,5,6,2,4,1,15,3,0,"https://fbref.com/en/players/bc49fd34/Jesus-Santiago"
2025,"Getafe","La Liga","Alex Sola","ESP","MF,FW","25-352",1999,11.4,21,14,9,12,0,9,25,36,16,8,0,8,7,28,11,1,"https://fbref.com/en/players/5fa714d5/Alex-Sola"
2025,"Getafe","La Liga","David Soria","ESP","GK","32-053",1993,38,4,4,4,0,0,4,5,80,1,0,0,0,1,5,21,3,"https://fbref.com/en/players/8f8c6934/David-Soria"
2025,"Getafe","La Liga","Ramón Terrats","ESP","MF,FW","24-221",2000,13.5,20,10,7,8,5,8,28,28.6,20,9,2,7,8,28,16,0,"https://fbref.com/en/players/f36016a5/Ramon-Terrats"
2025,"Getafe","La Liga","Christantus Uche","NGA","FW,MF","22-008",2003,27.6,35,21,8,19,8,9,20,45,11,20,2,18,10,45,19,0,"https://fbref.com/en/players/87941696/Christantus-Uche"
2025,"Getafe","La Liga","Bertuğ Yıldırım","TUR","FW","22-319",2002,12,10,5,0,7,3,2,7,28.6,5,13,2,11,1,11,16,0,"https://fbref.com/en/players/7410d325/Bertug-Yildirim"
2025,"Girona","La Liga","Iker Almena","ESP","FW,DF","21-023",2004,0.5,0,0,0,0,0,0,1,0,1,1,0,1,0,0,2,0,"https://fbref.com/en/players/0b32f721/Iker-Almena"
2025,"Girona","La Liga","Yaser Asprilla","COL","FW,MF","21-189",2003,15.6,22,12,6,8,8,8,23,34.8,15,14,0,14,7,29,7,1,"https://fbref.com/en/players/d139daf9/Yaser-Asprilla"
2025,"Girona","La Liga","Papa Ba","ESP","MF","20-257",2004,0.5,1,1,1,0,0,0,0,NA,0,1,0,1,0,1,1,0,"https://fbref.com/en/players/e0b0f636/Papa-Ba"
2025,"Girona","La Liga","Donny van de Beek","NED","MF","28-039",1997,15.8,29,18,17,7,5,13,26,50,13,19,3,16,10,39,12,0,"https://fbref.com/en/players/50dc94ce/Donny-van-de-Beek"
2025,"Girona","La Liga","Daley Blind","NED","DF","35-079",1990,30.9,49,27,26,19,4,31,48,64.6,17,32,9,23,32,81,94,2,"https://fbref.com/en/players/691bef82/Daley-Blind"
2025,"Girona","La Liga","Silvi Clúa","ESP","MF","20-118",2005,1.8,8,7,4,3,1,4,6,66.7,2,1,0,1,2,10,6,0,"https://fbref.com/en/players/b793dea2/Silvi-Clua"
2025,"Girona","La Liga","Arnaut Danjuma","NED","FW,MF","28-116",1997,14.8,8,6,3,3,2,2,7,28.6,5,5,1,4,2,10,4,0,"https://fbref.com/en/players/f08490a6/Arnaut-Danjuma"
2025,"Girona","La Liga","Alejandro Francés","ESP","DF","22-299",2002,13,36,24,22,13,1,28,40,70,12,17,8,9,17,53,52,0,"https://fbref.com/en/players/3e78a188/Alejandro-Frances"
2025,"Girona","La Liga","Paulo Gazzaniga","ARG","GK","33-145",1992,35.5,1,1,1,0,0,1,1,100,0,1,0,1,0,1,17,3,"https://fbref.com/en/players/63d17038/Paulo-Gazzaniga"
2025,"Girona","La Liga","Bryan Gil","ESP","FW,MF","24-105",2001,19.1,34,20,10,15,9,14,30,46.7,16,24,0,24,10,44,9,4,"https://fbref.com/en/players/7b5ab7f2/Bryan-Gil"
2025,"Girona","La Liga","Miguel Gutiérrez","ESP","DF,MF","23-304",2001,27.3,37,24,18,16,3,17,37,45.9,20,17,7,10,16,53,34,3,"https://fbref.com/en/players/7e98cff1/Miguel-Gutierrez"
2025,"Girona","La Liga","Yangel Herrera","VEN","MF","27-133",1998,25.1,66,39,31,27,8,30,59,50.8,29,24,8,16,31,97,50,2,"https://fbref.com/en/players/5083a734/Yangel-Herrera"
2025,"Girona","La Liga","Juanpe","ESP","DF","34-027",1991,8.1,8,5,5,3,0,6,8,75,2,15,10,5,8,16,56,1,"https://fbref.com/en/players/1633fc8a/Juanpe"
2025,"Girona","La Liga","Ladislav Krejčí","CZE","DF","26-037",1999,27.1,23,16,19,4,0,14,26,53.8,12,24,19,5,34,57,93,5,"https://fbref.com/en/players/5b5c2228/Ladislav-Krejci"
2025,"Girona","La Liga","David López","ESP","DF","35-230",1989,27,32,24,22,7,3,18,31,58.1,13,22,12,10,14,46,111,2,"https://fbref.com/en/players/f03f284b/David-Lopez"
2025,"Girona","La Liga","Pau López","ESP","GK","30-165",1994,0.5,0,0,0,0,0,0,0,NA,0,0,0,0,0,0,1,0,"https://fbref.com/en/players/20b9f052/Pau-Lopez"
2025,"Girona","La Liga","Iván Martín","ESP","MF","26-102",1999,22.7,32,19,14,14,4,15,34,44.1,19,20,6,14,11,43,15,1,"https://fbref.com/en/players/ae48c5cb/Ivan-Martin"
2025,"Girona","La Liga","Arnau Martinez","ESP","DF,MF","22-032",2003,29.2,51,28,30,15,6,32,63,50.8,31,18,6,12,31,82,76,2,"https://fbref.com/en/players/c3e66ffe/Arnau-Martinez"
2025,"Girona","La Liga","Arthur Melo","BRA","MF","28-288",1996,10.5,25,11,8,12,5,14,27,51.9,13,5,1,4,8,33,12,1,"https://fbref.com/en/players/48b3dd60/Arthur-Melo"
2025,"Girona","La Liga","Kim Minsu","KOR","MF,FW","19-128",2006,0.2,1,0,0,1,0,0,0,NA,0,0,0,0,0,1,0,0,"https://fbref.com/en/players/11e36e68/Kim-Minsu"
2025,"Girona","La Liga","Bojan Miovski","MKD","FW","25-337",1999,9.7,7,5,2,2,3,2,7,28.6,5,4,0,4,2,9,7,0,"https://fbref.com/en/players/72e442c5/Bojan-Miovski"
2025,"Girona","La Liga","Gabriel Osei Misehouy","NED","FW,MF","19-313",2005,2.9,1,1,0,1,0,0,1,0,1,0,0,0,0,1,0,0,"https://fbref.com/en/players/349a7574/Gabriel-Osei-Misehouy"
2025,"Girona","La Liga","Portu","ESP","FW,MF","33-006",1992,8.7,13,7,5,5,3,7,10,70,3,8,0,8,0,13,2,0,"https://fbref.com/en/players/1bda5842/Portu"
2025,"Girona","La Liga","Oriol Romeu","ESP","MF","33-245",1991,15.1,38,25,14,19,5,14,26,53.8,12,22,8,14,12,50,20,4,"https://fbref.com/en/players/4b511457/Oriol-Romeu"
2025,"Girona","La Liga","Abel Ruiz","ESP","FW","25-119",2000,15,6,2,2,2,2,2,5,40,3,7,2,5,5,11,7,0,"https://fbref.com/en/players/6cbf8d0d/Abel-Ruiz"
2025,"Girona","La Liga","Ferrán Ruiz","ESP","MF","22-031",2003,0.2,0,0,0,0,0,0,0,NA,0,2,1,1,1,1,0,0,"https://fbref.com/en/players/4e4b8e97/Ferran-Ruiz"
2025,"Girona","La Liga","Jhon Solis","COL","MF","20-236",2004,5.9,13,7,3,9,1,6,14,42.9,8,13,1,12,4,17,6,1,"https://fbref.com/en/players/1282939a/Jhon-Solis"
2025,"Girona","La Liga","Cristhian Stuani","URU","FW","38-227",1986,12,9,7,1,7,1,5,8,62.5,3,4,1,3,7,16,11,0,"https://fbref.com/en/players/220c11f1/Cristhian-Stuani"
2025,"Girona","La Liga","Viktor Tsyhankov","UKR","FW,MF","27-193",1997,21.3,19,12,4,7,8,9,19,47.4,10,7,1,6,15,34,16,1,"https://fbref.com/en/players/f7e87032/Viktor-Tsyhankov"
2025,"Girona","La Liga","Krapyvtsov Vladyslav","UKR","GK","19-336",2005,2,0,0,0,0,0,0,0,NA,0,0,0,0,0,0,1,1,"https://fbref.com/en/players/66daeaf7/Krapyvtsov-Vladyslav"
2025,"Gladbach","Bundesliga","Tiago Cardoso","LUX","GK","19-050",2006,4.2,1,0,1,0,0,1,1,100,0,0,0,0,0,1,2,2,"https://fbref.com/en/players/79268b9c/Tiago-Cardoso"
2025,"Gladbach","Bundesliga","Fabio Chiarodia","ITA","DF","19-356",2005,4.2,10,4,6,4,0,4,6,66.7,2,8,3,5,9,19,53,1,"https://fbref.com/en/players/48780156/Fabio-Chiarodia"
2025,"Gladbach","Bundesliga","Tomáš Čvančara","CZE","FW","24-287",2000,9.2,4,1,3,1,0,2,7,28.6,5,6,3,3,5,9,17,0,"https://fbref.com/en/players/298c8aa1/Tomas-Cvancara"
2025,"Gladbach","Bundesliga","Nico Elvedi","SUI","DF","28-239",1996,23.7,38,23,28,6,4,17,23,73.9,6,35,27,8,30,68,163,0,"https://fbref.com/en/players/48035304/Nico-Elvedi"
2025,"Gladbach","Bundesliga","Marvin Friedrich","GER","DF","29-165",1995,11,15,9,12,3,0,9,16,56.3,7,16,12,4,5,20,57,0,"https://fbref.com/en/players/b77f44a4/Marvin-Friedrich"
2025,"Gladbach","Bundesliga","Shiō Fukuda","JPN","FW","21-049",2004,0.7,0,0,0,0,0,0,0,NA,0,1,0,1,0,0,0,0,"https://fbref.com/en/players/056a8552/Shio-Fukuda"
2025,"Gladbach","Bundesliga","Robin Hack","GER","FW,MF","26-273",1998,24.1,22,17,11,8,3,12,28,42.9,16,30,2,28,9,31,28,0,"https://fbref.com/en/players/0174ba21/Robin-Hack"
2025,"Gladbach","Bundesliga","Franck Honorat","FRA","FW","28-289",1996,16,17,7,10,4,3,2,8,25,6,9,1,8,5,22,28,1,"https://fbref.com/en/players/db7849ca/Franck-Honorat"
2025,"Gladbach","Bundesliga","Ko Itakura","JPN","DF","28-120",1997,31,40,29,23,16,1,21,34,61.8,13,41,22,19,28,68,171,0,"https://fbref.com/en/players/97d545ae/Ko-Itakura"
2025,"Gladbach","Bundesliga","Tim Kleindienst","GER","FW","29-269",1995,30.4,30,15,6,15,9,10,35,28.6,25,45,9,36,12,42,66,1,"https://fbref.com/en/players/258a6f4d/Tim-Kleindienst"
2025,"Gladbach","Bundesliga","Stefan Lainer","AUT","DF","32-273",1992,8.4,22,13,16,5,1,12,14,85.7,2,12,6,6,12,34,30,0,"https://fbref.com/en/players/4aea5077/Stefan-Lainer"
2025,"Gladbach","Bundesliga","Nathan N'Goumou","CMR","FW","25-074",2000,9.2,17,11,11,4,2,6,11,54.5,5,8,2,6,4,21,16,0,"https://fbref.com/en/players/e110ea4b/Nathan-NGoumou"
2025,"Gladbach","Bundesliga","Luca Netz","GER","DF","22-012",2003,10.8,24,14,14,8,2,13,19,68.4,6,17,4,13,10,34,36,0,"https://fbref.com/en/players/e79269bd/Luca-Netz"
2025,"Gladbach","Bundesliga","Florian Neuhaus","GER","MF","28-072",1997,4.2,10,3,7,3,0,7,17,41.2,10,9,2,7,6,16,5,1,"https://fbref.com/en/players/36a59ba4/Florian-Neuhaus"
2025,"Gladbach","Bundesliga","Moritz Nicolas","GER","GK","27-218",1997,18.2,0,0,0,0,0,0,0,NA,0,1,0,1,1,1,8,1,"https://fbref.com/en/players/226ddf9d/Moritz-Nicolas"
2025,"Gladbach","Bundesliga","Jonas Omlin","SUI","GK","31-137",1994,10.9,0,0,0,0,0,0,1,0,1,0,0,0,0,0,5,1,"https://fbref.com/en/players/c631f952/Jonas-Omlin"
2025,"Gladbach","Bundesliga","Noah Pesch","CRO","FW","20-009",2005,0.1,1,0,0,0,1,0,0,NA,0,0,0,0,0,1,0,0,"https://fbref.com/en/players/19704b7c/Noah-Pesch"
2025,"Gladbach","Bundesliga","Alassane Pléa","FRA","MF,FW","32-078",1993,21.1,7,3,0,2,5,4,13,30.8,9,11,0,11,2,9,7,1,"https://fbref.com/en/players/bc6bd723/Alassane-Plea"
2025,"Gladbach","Bundesliga","Grant Ranos","ARM","FW","21-311",2003,0.2,1,0,0,1,0,0,1,0,1,2,0,2,0,1,0,0,"https://fbref.com/en/players/0ee6ea6a/Grant-Ranos"
2025,"Gladbach","Bundesliga","Rocco Reitz","GER","MF","22-363",2002,20.3,52,24,24,24,4,24,43,55.8,19,39,16,23,53,105,59,2,"https://fbref.com/en/players/cc971106/Rocco-Reitz"
2025,"Gladbach","Bundesliga","Philipp Sander","GER","MF","27-095",1998,15.6,33,17,16,15,2,10,23,43.5,13,16,7,9,23,56,44,3,"https://fbref.com/en/players/5c90bad8/Philipp-Sander"
2025,"Gladbach","Bundesliga","Joe Scally","USA","DF","22-147",2002,28.6,45,32,25,18,2,27,46,58.7,19,35,11,24,16,61,86,2,"https://fbref.com/en/players/236f02cd/Joe-Scally"
2025,"Gladbach","Bundesliga","Tobias Sippel","GER","GK","37-066",1988,0.7,0,0,0,0,0,0,0,NA,0,0,0,0,0,0,0,0,"https://fbref.com/en/players/0d8a37c2/Tobias-Sippel"
2025,"Gladbach","Bundesliga","Kevin Stöger","AUT","MF","31-273",1993,17.2,37,21,23,10,4,16,39,41,23,24,3,21,16,53,26,3,"https://fbref.com/en/players/e5649a78/Kevin-Stoger"
2025,"Gladbach","Bundesliga","Lukas Ullrich","GER","DF","21-072",2004,21.1,25,16,18,6,1,15,42,35.7,27,26,9,17,23,48,74,1,"https://fbref.com/en/players/d646c218/Lukas-Ullrich"
2025,"Gladbach","Bundesliga","Julian Weigl","GER","MF","29-261",1995,32,53,25,24,24,5,28,46,60.9,18,54,27,27,48,101,86,3,"https://fbref.com/en/players/346d51d9/Julian-Weigl"
2025,"Heidenheim","Bundesliga","Adrian Beck","GER","MF,FW","27-352",1997,17.8,36,17,18,12,6,12,35,34.3,23,31,2,29,9,45,17,0,"https://fbref.com/en/players/616c09f5/Adrian-Beck"
2025,"Heidenheim","Bundesliga","Maximilian Breunig","GER","FW,MF","24-286",2000,3.9,4,3,1,2,1,3,6,50,3,9,2,7,1,5,3,0,"https://fbref.com/en/players/1e37c986/Maximilian-Breunig"
2025,"Heidenheim","Bundesliga","Marnon Busch","GER","DF,MF","30-170",1994,15.5,26,17,19,7,0,23,32,71.9,9,23,10,13,13,39,65,5,"https://fbref.com/en/players/c38767ab/Marnon-Busch"
2025,"Heidenheim","Bundesliga","Sirlord Conteh","GER","FW,MF","28-322",1996,9.9,9,5,3,6,0,2,7,28.6,5,1,1,0,1,10,8,0,"https://fbref.com/en/players/34e09d5f/Sirlord-Conteh"
2025,"Heidenheim","Bundesliga","Niklas Dorsch","GER","MF","27-132",1998,14.8,27,16,12,15,0,13,22,59.1,9,14,1,13,17,44,17,2,"https://fbref.com/en/players/7f73bdf4/Niklas-Dorsch"
2025,"Heidenheim","Bundesliga","Frank Feller","GER","GK","21-140",2004,1.3,0,0,0,0,0,0,0,NA,0,0,0,0,0,0,1,0,"https://fbref.com/en/players/ccd0981f/Frank-Feller"
2025,"Heidenheim","Bundesliga","Jonas Föhrenbach","GER","DF","29-121",1996,20.4,45,24,25,15,5,22,35,62.9,13,29,3,26,16,61,57,0,"https://fbref.com/en/players/1b4be8eb/Jonas-Fohrenbach"
2025,"Heidenheim","Bundesliga","Benedikt Gimber","GER","DF","28-097",1997,29.7,72,46,48,23,1,38,63,60.3,25,53,19,34,31,103,131,1,"https://fbref.com/en/players/e5f76710/Benedikt-Gimber"
2025,"Heidenheim","Bundesliga","Mathias Honsak","AUT","FW,DF","28-158",1996,13.1,15,8,10,5,0,10,23,43.5,13,19,4,15,10,25,31,0,"https://fbref.com/en/players/3dbdbb6a/Mathias-Honsak"
2025,"Heidenheim","Bundesliga","Mikkel Kaufmann","DEN","FW","24-144",2001,4.1,6,4,1,3,2,2,5,40,3,5,2,3,2,8,7,0,"https://fbref.com/en/players/6e269dd3/Mikkel-Kaufmann"
2025,"Heidenheim","Bundesliga","Thomas Keller","GER","DF,MF","25-295",1999,1.6,6,5,5,1,0,4,6,66.7,2,3,1,2,4,10,11,0,"https://fbref.com/en/players/285c7011/Thomas-Keller"
2025,"Heidenheim","Bundesliga","Luca Kerber","GER","MF,DF","23-078",2002,8.7,26,16,17,8,1,16,31,51.6,15,14,4,10,5,31,25,1,"https://fbref.com/en/players/c107935c/Luca-Kerber"
2025,"Heidenheim","Bundesliga","Frans Krätzig","GER","DF,MF","22-133",2003,13.5,32,18,14,12,6,12,21,57.1,9,12,1,11,17,49,15,0,"https://fbref.com/en/players/1fc08838/Frans-Kratzig"
2025,"Heidenheim","Bundesliga","Patrick Mainka","GER","DF","30-202",1994,34,58,30,36,20,2,35,55,63.6,20,61,36,25,68,126,206,0,"https://fbref.com/en/players/dd9caa07/Patrick-Mainka"
2025,"Heidenheim","Bundesliga","Lennard Maloney","USA","MF","25-231",1999,8.4,20,11,12,7,1,14,23,60.9,9,9,2,7,14,34,38,0,"https://fbref.com/en/players/75402e99/Lennard-Maloney"
2025,"Heidenheim","Bundesliga","Kevin Müller","GER","GK","34-073",1991,32.7,3,2,3,0,0,3,3,100,0,0,0,0,0,3,13,4,"https://fbref.com/en/players/f256f213/Kevin-Muller"
2025,"Heidenheim","Bundesliga","Julian Niehues","GER","MF","24-040",2001,1.7,3,1,3,0,0,1,5,20,4,1,0,1,0,3,8,0,"https://fbref.com/en/players/5bc27912/Julian-Niehues"
2025,"Heidenheim","Bundesliga","Marvin Pieringer","GER","FW,MF","25-235",1999,24.5,23,13,5,12,6,5,10,50,5,21,2,19,8,31,32,0,"https://fbref.com/en/players/11407d95/Marvin-Pieringer"
2025,"Heidenheim","Bundesliga","Stefan Schimmer","GER","FW,MF","31-029",1994,2.7,2,0,1,1,0,1,2,50,1,1,0,1,0,2,4,0,"https://fbref.com/en/players/395bbb60/Stefan-Schimmer"
2025,"Heidenheim","Bundesliga","Jan Schöppner","GER","MF","25-349",1999,29.8,56,30,19,27,10,20,58,34.5,38,38,6,32,43,99,95,1,"https://fbref.com/en/players/932bfcac/Jan-Schoppner"
2025,"Heidenheim","Bundesliga","Léo Scienza","BRA","FW,MF","26-256",1998,12.8,17,12,10,5,2,7,18,38.9,11,13,1,12,5,22,9,1,"https://fbref.com/en/players/79064bc9/Leo-Scienza"
2025,"Heidenheim","Bundesliga","Tim Siersleben","GER","DF","25-079",2000,13.1,21,14,12,8,1,7,17,41.2,10,19,6,13,20,41,66,0,"https://fbref.com/en/players/f761c901/Tim-Siersleben"
2025,"Heidenheim","Bundesliga","Norman Theuerkauf","GER","MF","38-123",1987,0.2,0,0,0,0,0,0,0,NA,0,0,0,0,0,0,0,0,"https://fbref.com/en/players/0cbf4c54/Norman-Theuerkauf"
2025,"Heidenheim","Bundesliga","Denis Thomalla","GER","MF","32-284",1992,0,0,0,0,0,0,0,0,NA,0,0,0,0,0,0,0,0,"https://fbref.com/en/players/b9ac6e0e/Denis-Thomalla"
2025,"Heidenheim","Bundesliga","Omar Traoré","GER","DF","27-112",1998,29.1,50,26,31,16,3,25,41,61,16,35,6,29,21,71,66,0,"https://fbref.com/en/players/f44e8a73/Omar-Traore"
2025,"Heidenheim","Bundesliga","Paul Wanner","GER","MF,FW","19-155",2005,19.7,40,27,16,21,3,15,32,46.9,17,15,0,15,4,44,20,0,"https://fbref.com/en/players/cb64672e/Paul-Wanner"
2025,"Heidenheim","Bundesliga","Budu Zivzivadze","GEO","FW","31-078",1994,10.6,17,11,1,9,7,4,8,50,4,9,0,9,3,20,7,0,"https://fbref.com/en/players/e3a72b89/Budu-Zivzivadze"
2025,"Hellas Verona","Serie A","Junior Ajayi","CIV","FW","20-228",2004,0.1,0,0,0,0,0,0,0,NA,0,0,0,0,0,0,0,0,"https://fbref.com/en/players/cab600a8/Junior-Ajayi"
2025,"Hellas Verona","Serie A","Faride Alidou","GER","FW,MF","23-313",2001,0.8,0,0,0,0,0,0,0,NA,0,1,0,1,1,1,3,1,"https://fbref.com/en/players/00f518d8/Faride-Alidou"
2025,"Hellas Verona","Serie A","Daniel Bandeira","POR","MF","25-046",2000,4.5,4,0,1,3,0,3,6,50,3,2,1,1,6,10,8,0,"https://fbref.com/en/players/56fca564/Daniel-Bandeira"
2025,"Hellas Verona","Serie A","Reda Belahyane","MAR","MF","20-360",2004,18.4,36,26,16,13,7,13,17,76.5,4,20,9,11,10,46,22,1,"https://fbref.com/en/players/705a1642/Reda-Belahyane"
2025,"Hellas Verona","Serie A","Antoine Bernede","FRA","MF","26-001",1999,6.6,15,8,4,9,2,10,16,62.5,6,6,1,5,5,20,3,0,"https://fbref.com/en/players/07a821e4/Antoine-Bernede"
2025,"Hellas Verona","Serie A","Domagoj Bradarić","CRO","DF","25-168",1999,21.5,36,28,21,11,4,18,29,62.1,11,17,4,13,15,51,49,1,"https://fbref.com/en/players/8bbe2df5/Domagoj-Bradaric"
2025,"Hellas Verona","Serie A","Alphadjo Cissè","ITA","FW,MF","18-217",2006,0.1,0,0,0,0,0,0,0,NA,0,0,0,0,0,0,0,0,"https://fbref.com/en/players/d079becb/Alphadjo-Cisse"
2025,"Hellas Verona","Serie A","Diego Coppola","ITA","DF","21-150",2003,32.5,66,36,48,14,4,28,40,70,12,44,24,20,72,138,194,2,"https://fbref.com/en/players/22ae86f9/Diego-Coppola"
2025,"Hellas Verona","Serie A","Flavius Daniliuc","AUT","DF","24-030",2001,11.2,26,21,14,9,3,15,24,62.5,9,10,3,7,7,33,27,0,"https://fbref.com/en/players/7ef972c3/Flavius-Daniliuc"
2025,"Hellas Verona","Serie A","Paweł Dawidowicz","POL","DF,MF","30-007",1995,20.5,45,24,20,22,3,18,27,66.7,9,16,6,10,20,65,70,2,"https://fbref.com/en/players/16bb656a/Pawel-Dawidowicz"
2025,"Hellas Verona","Serie A","Ondrej Duda","SVK","MF","30-173",1994,26.6,46,27,21,22,3,29,64,45.3,35,28,9,19,31,77,30,4,"https://fbref.com/en/players/79ca3e23/Ondrej-Duda"
2025,"Hellas Verona","Serie A","Davide Faraoni","ITA","DF","33-214",1991,2.9,10,9,5,5,0,3,9,33.3,6,7,3,4,2,12,12,1,"https://fbref.com/en/players/aae9d04a/Davide-Faraoni"
2025,"Hellas Verona","Serie A","Martin Frese","DEN","DF","27-143",1998,6.1,18,11,7,10,1,7,13,53.8,6,5,1,4,8,26,16,1,"https://fbref.com/en/players/b910e9c0/Martin-Frese"
2025,"Hellas Verona","Serie A","Daniele Ghilardi","ITA","DF","22-141",2003,22.5,44,29,27,17,0,25,41,61,16,29,15,14,30,74,106,0,"https://fbref.com/en/players/9cedad4b/Daniele-Ghilardi"
2025,"Hellas Verona","Serie A","Abdou Harroui","NED","MF,FW","27-134",1998,5.1,9,6,6,3,0,4,4,100,0,5,0,5,2,11,5,0,"https://fbref.com/en/players/65fd099c/Abdou-Harroui"
2025,"Hellas Verona","Serie A","Grigoris Kastanos","CYP","MF,FW","27-117",1998,9.7,23,16,8,7,8,9,21,42.9,12,17,2,15,7,30,8,0,"https://fbref.com/en/players/2a82aa85/Grigoris-Kastanos"
2025,"Hellas Verona","Serie A","Mathis Lambourde","FRA","FW,MF","19-138",2006,1,3,1,2,1,0,1,3,33.3,2,3,0,3,0,3,1,0,"https://fbref.com/en/players/0da3d7ab/Mathis-Lambourde"
2025,"Hellas Verona","Serie A","Darko Lazović","SRB","DF,MF","34-254",1990,16.2,21,10,5,14,2,11,28,39.3,17,19,3,16,11,32,39,0,"https://fbref.com/en/players/5128bde4/Darko-Lazovic"
2025,"Hellas Verona","Serie A","Dailon Livramento","CPV","FW,MF","24-023",2001,10.4,15,11,2,7,6,7,13,53.8,6,10,2,8,3,18,9,0,"https://fbref.com/en/players/c115db1e/Dailon-Livramento"
2025,"Hellas Verona","Serie A","Giangiacomo Magnani","ITA","DF","29-235",1995,11.8,20,15,14,6,0,7,7,100,0,16,9,7,17,37,73,1,"https://fbref.com/en/players/cce9f582/Giangiacomo-Magnani"
2025,"Hellas Verona","Serie A","Lorenzo Montipò","ITA","GK","29-096",1996,36,1,0,1,0,0,1,4,25,3,0,0,0,0,1,24,4,"https://fbref.com/en/players/c1d95617/Lorenzo-Montipo"
2025,"Hellas Verona","Serie A","Daniel Mosquera","COL","FW","25-219",1999,15.3,11,8,3,5,3,1,15,6.7,14,11,1,10,2,13,10,0,"https://fbref.com/en/players/091b9eb8/Daniel-Mosquera"
2025,"Hellas Verona","Serie A","Yllan Okou","FRA","DF","22-155",2002,0,0,0,0,0,0,0,0,NA,0,1,0,1,0,0,0,0,"https://fbref.com/en/players/fa753b79/Yllan-Okou"
2025,"Hellas Verona","Serie A","Daniel Oyegoke","ENG","DF","22-144",2003,1.1,2,2,1,0,1,1,1,100,0,1,0,1,1,3,7,0,"https://fbref.com/en/players/c9866d69/Daniel-Oyegoke"
2025,"Hellas Verona","Serie A","Simone Perilli","ITA","GK","30-140",1995,2,0,0,0,0,0,0,0,NA,0,0,0,0,0,0,1,0,"https://fbref.com/en/players/b9e11c1d/Simone-Perilli"
2025,"Hellas Verona","Serie A","Amin Sarr","SWE","FW","24-077",2001,21.2,22,12,3,8,11,5,10,50,5,18,3,15,3,25,14,0,"https://fbref.com/en/players/d5326924/Amin-Sarr"
2025,"Hellas Verona","Serie A","Suat Serdar","GER","MF","28-046",1997,15.3,35,22,12,19,4,10,26,38.5,16,19,4,15,8,43,21,0,"https://fbref.com/en/players/b3325a30/Suat-Serdar"
2025,"Hellas Verona","Serie A","Tomáš Suslov","SVK","MF,FW","22-354",2002,23.1,54,38,23,24,7,23,72,31.9,49,30,2,28,18,72,17,1,"https://fbref.com/en/players/83fe71b8/Tomas-Suslov"
2025,"Hellas Verona","Serie A","Jackson Tchatchoua","CMR","DF,MF","23-255",2001,35.2,50,31,34,13,3,28,43,65.1,15,21,9,12,14,64,75,2,"https://fbref.com/en/players/aeca7743/Jackson-Tchatchoua"
2025,"Hellas Verona","Serie A","Casper Tengstedt","DEN","FW","24-360",2000,16.9,7,5,0,5,2,4,9,44.4,5,5,1,4,4,11,29,0,"https://fbref.com/en/players/ff2fb007/Casper-Tengstedt"
2025,"Hellas Verona","Serie A","Cheikh Tidiane Niasse","SEN","MF","25-128",2000,8.4,18,15,6,12,0,10,19,52.6,9,17,4,13,17,35,17,2,"https://fbref.com/en/players/ff20acfe/Cheikh-Tidiane-Niasse"
2025,"Hellas Verona","Serie A","Nicolás Valentini","ARG","DF","24-051",2001,12.5,35,23,22,12,1,20,31,64.5,11,15,7,8,15,50,97,0,"https://fbref.com/en/players/a43e4f9c/Nicolas-Valentini"
2025,"Hoffenheim","Bundesliga","Kevin Akpoguma","NGA","DF","30-038",1995,24.7,54,27,36,12,6,30,46,65.2,16,65,37,28,29,83,115,1,"https://fbref.com/en/players/6ec6fde0/Kevin-Akpoguma"
2025,"Hoffenheim","Bundesliga","Oliver Baumann","GER","GK","34-359",1990,28,2,2,2,0,0,2,4,50,2,0,0,0,0,2,15,2,"https://fbref.com/en/players/47064058/Oliver-Baumann"
2025,"Hoffenheim","Bundesliga","Ihlas Bebou","TOG","MF","31-034",1994,0.1,0,0,0,0,0,0,0,NA,0,0,0,0,0,0,0,0,"https://fbref.com/en/players/a53b661f/Ihlas-Bebou"
2025,"Hoffenheim","Bundesliga","Hannes Behrens","GER","DF","",NA,0.3,1,1,0,1,0,0,0,NA,0,1,0,1,2,3,0,0,"https://fbref.com/en/players/ca788298/Hannes-Behrens"
2025,"Hoffenheim","Bundesliga","Mergim Berisha","GER","FW,MF","27-016",1998,3.7,3,3,1,2,0,0,3,0,3,2,1,1,0,3,3,0,"https://fbref.com/en/players/eb6e14be/Mergim-Berisha"
2025,"Hoffenheim","Bundesliga","Tom Bischof","GER","MF,FW","19-333",2005,28.4,95,53,36,45,14,40,77,51.9,37,66,11,55,30,125,53,1,"https://fbref.com/en/players/07d3bfec/Tom-Bischof"
2025,"Hoffenheim","Bundesliga","Jacob Bruun Larsen","DEN","FW,MF","26-250",1998,4.4,4,3,1,2,1,3,8,37.5,5,5,1,4,1,5,2,0,"https://fbref.com/en/players/4e204552/Jacob-Bruun-Larsen"
2025,"Hoffenheim","Bundesliga","Marius Bülter","GER","FW,DF","32-059",1993,19.2,13,10,5,6,2,9,17,52.9,8,10,3,7,4,17,14,1,"https://fbref.com/en/players/ab5b7dc1/Marius-Bulter"
2025,"Hoffenheim","Bundesliga","Arthur Chaves","BRA","DF","24-118",2001,24.3,51,36,28,19,4,25,50,50,25,47,20,27,37,88,136,3,"https://fbref.com/en/players/913e4711/Arthur-Chaves"
2025,"Hoffenheim","Bundesliga","Tim Drexler","GER","DF","20-082",2005,4,17,7,11,6,0,9,12,75,3,6,4,2,1,18,9,1,"https://fbref.com/en/players/0911b4fc/Tim-Drexler"
2025,"Hoffenheim","Bundesliga","Dennis Geiger","GER","MF,FW","26-351",1998,8.2,24,11,9,13,2,12,19,63.2,7,15,2,13,7,31,6,1,"https://fbref.com/en/players/37f606f0/Dennis-Geiger"
2025,"Hoffenheim","Bundesliga","Valentin Gendrey","FRA","DF","24-340",2000,15.7,30,12,19,9,2,11,18,61.1,7,19,5,14,15,45,53,0,"https://fbref.com/en/players/822ed0ec/Valentin-Gendrey"
2025,"Hoffenheim","Bundesliga","Florian Grillitsch","AUT","MF","29-293",1995,6.7,15,9,5,9,1,8,14,57.1,6,6,2,4,8,23,18,0,"https://fbref.com/en/players/ffbbc83b/Florian-Grillitsch"
2025,"Hoffenheim","Bundesliga","Paul Hennrich","GER","MF","20-082",2005,0.1,0,0,0,0,0,0,0,NA,0,1,1,0,0,0,0,0,"https://fbref.com/en/players/ffaf1c99/Paul-Hennrich"
2025,"Hoffenheim","Bundesliga","Adam Hložek","CZE","FW,MF","22-306",2002,20.8,22,10,7,8,7,11,20,55,9,13,1,12,4,26,20,0,"https://fbref.com/en/players/5521f419/Adam-Hlozek"
2025,"Hoffenheim","Bundesliga","Robin Hranáč","CZE","DF","25-118",2000,2.4,0,0,0,0,0,0,1,0,1,3,2,1,5,5,9,1,"https://fbref.com/en/players/95d5aea2/Robin-Hranac"
2025,"Hoffenheim","Bundesliga","David Jurásek","CZE","DF","24-293",2000,6.9,6,3,3,2,1,2,5,40,3,5,0,5,6,12,17,0,"https://fbref.com/en/players/d7a03bf3/David-Jurasek"
2025,"Hoffenheim","Bundesliga","Pavel Kadeřábek","CZE","DF","33-032",1992,17.5,25,14,14,4,7,15,31,48.4,16,13,3,10,20,45,54,1,"https://fbref.com/en/players/79c90e45/Pavel-Kaderabek"
2025,"Hoffenheim","Bundesliga","Andrej Kramarić","CRO","MF,FW","33-342",1991,30.7,15,8,5,8,2,6,11,54.5,5,16,3,13,7,22,11,1,"https://fbref.com/en/players/603cb947/Andrej-Kramaric"
2025,"Hoffenheim","Bundesliga","Florian Micheler","AUT","MF","20-010",2005,0.4,0,0,0,0,0,0,2,0,2,0,0,0,0,0,0,0,"https://fbref.com/en/players/0024cb81/Florian-Micheler"
2025,"Hoffenheim","Bundesliga","Max Moerstedt","GER","FW","",NA,5,5,5,1,3,1,1,2,50,1,4,0,4,0,5,5,0,"https://fbref.com/en/players/710045fb/Max-Moerstedt"
2025,"Hoffenheim","Bundesliga","David Mokwa","FRA","DF,FW","21-024",2004,0.2,1,0,1,0,0,0,0,NA,0,0,0,0,0,1,0,0,"https://fbref.com/en/players/f8bd4ad4/David-Mokwa"
2025,"Hoffenheim","Bundesliga","Stanley N'Soki","FRA","DF","26-048",1999,14.5,22,16,13,7,2,12,23,52.2,11,22,7,15,26,48,58,3,"https://fbref.com/en/players/61590953/Stanley-NSoki"
2025,"Hoffenheim","Bundesliga","Finn Ole Becker","GER","MF","24-353",2000,7.4,11,5,4,6,1,1,4,25,3,7,3,4,10,21,20,0,"https://fbref.com/en/players/dd2e62da/Finn-Ole-Becker"
2025,"Hoffenheim","Bundesliga","Gift Orban","NGA","FW","22-314",2002,7.6,3,1,2,1,0,1,6,16.7,5,7,0,7,0,3,3,0,"https://fbref.com/en/players/de17db90/Gift-Orban"
2025,"Hoffenheim","Bundesliga","Luca Philipp","GER","GK","24-180",2000,6,1,0,1,0,0,1,1,100,0,0,0,0,0,1,1,0,"https://fbref.com/en/players/eb3e717e/Luca-Philipp"
2025,"Hoffenheim","Bundesliga","Alexander Prass","AUT","DF","24-001",2001,17.4,42,23,24,15,3,24,59,40.7,35,33,6,27,9,51,53,4,"https://fbref.com/en/players/6637e6a7/Alexander-Prass"
2025,"Hoffenheim","Bundesliga","Grischa Prömel","GER","MF","30-138",1995,1.9,0,0,0,0,0,0,1,0,1,1,1,0,2,2,4,0,"https://fbref.com/en/players/924f9191/Grischa-Promel"
2025,"Hoffenheim","Bundesliga","Diadie Samassékou","MLI","MF","29-136",1996,3.2,5,5,1,2,2,2,4,50,2,4,2,2,5,10,5,0,"https://fbref.com/en/players/08593525/Diadie-Samassekou"
2025,"Hoffenheim","Bundesliga","Leo Skiri Østigård","NOR","DF","25-180",1999,10.3,9,7,5,4,0,4,6,66.7,2,17,9,8,9,18,111,0,"https://fbref.com/en/players/b35a7399/Leo-Skiri-Ostigard"
2025,"Hoffenheim","Bundesliga","Anton Stach","GER","MF,DF","26-193",1998,28.7,66,46,25,37,4,32,47,68.1,15,47,13,34,46,112,101,2,"https://fbref.com/en/players/0f59a7bf/Anton-Stach"
2025,"Hoffenheim","Bundesliga","Haris Tabakovic","BIH","FW","30-341",1994,9.1,3,1,1,0,2,0,3,0,3,4,2,2,1,4,16,0,"https://fbref.com/en/players/723b19c7/Haris-Tabakovic"
2025,"Hoffenheim","Bundesliga","Umut Tohumcu","GER","MF,FW","20-289",2004,4.2,9,5,3,5,1,5,7,71.4,2,5,0,5,3,12,6,0,"https://fbref.com/en/players/e547d3cf/Umut-Tohumcu"
2025,"Hoffenheim","Bundesliga","Bazoumana Touré","CIV","FW,MF","19-086",2006,6.8,12,10,2,7,3,2,8,25,6,4,0,4,3,15,2,0,"https://fbref.com/en/players/93945a50/Bazoumana-Toure"
2025,"Hoffenheim","Bundesliga","Erencan Yardimci","TUR","FW,MF","23-112",2002,3.5,4,3,1,3,0,1,2,50,1,2,0,2,1,5,2,0,"https://fbref.com/en/players/b7481dc0/Erencan-Yardimci"
2025,"Holstein Kiel","Bundesliga","Jann-Fiete Arp","GER","FW,MF","25-141",2000,7.9,13,10,5,2,6,4,13,30.8,9,6,0,6,3,16,8,1,"https://fbref.com/en/players/c21fb312/Jann-Fiete-Arp"
2025,"Holstein Kiel","Bundesliga","Timo Becker","GER","DF","28-063",1997,27.2,53,33,39,9,5,34,46,73.9,12,30,17,13,17,70,110,1,"https://fbref.com/en/players/543ddcaf/Timo-Becker"
2025,"Holstein Kiel","Bundesliga","Alexander Bernhardsson","SWE","FW,MF","26-261",1998,14,29,15,9,9,11,20,31,64.5,11,14,0,14,5,34,25,0,"https://fbref.com/en/players/dea1d183/Alexander-Bernhardsson"
2025,"Holstein Kiel","Bundesliga","Thomas Dähne","GER","GK","31-143",1994,9,0,0,0,0,0,0,0,NA,0,0,0,0,0,0,7,2,"https://fbref.com/en/players/f194035d/Thomas-Dahne"
2025,"Holstein Kiel","Bundesliga","Patrick Erras","GER","DF","30-126",1995,9.2,8,5,6,2,0,2,9,22.2,7,13,11,2,9,17,64,0,"https://fbref.com/en/players/e3f6253d/Patrick-Erras"
2025,"Holstein Kiel","Bundesliga","Max Geschwill","GER","DF","23-324",2001,14.2,26,21,13,12,1,14,19,73.7,5,14,9,5,30,56,53,1,"https://fbref.com/en/players/0ffda76d/Max-Geschwill"
2025,"Holstein Kiel","Bundesliga","Armin Gigovic","BIH","MF","23-051",2002,21.1,25,13,14,8,3,5,21,23.8,16,20,1,19,21,46,33,0,"https://fbref.com/en/players/d0a0858e/Armin-Gigovic"
2025,"Holstein Kiel","Bundesliga","Phil Harres","GER","FW","23-063",2002,17.2,10,10,3,4,3,4,8,50,4,17,3,14,5,15,20,0,"https://fbref.com/en/players/07db670d/Phil-Harres"
2025,"Holstein Kiel","Bundesliga","Lewis Holtby","GER","MF","34-251",1990,13.8,34,20,19,10,5,12,28,42.9,16,14,2,12,21,55,26,3,"https://fbref.com/en/players/410ab123/Lewis-Holtby"
2025,"Holstein Kiel","Bundesliga","Marko Ivezić","SRB","DF","23-176",2001,18.4,29,19,20,6,3,15,42,35.7,27,25,13,12,27,56,103,2,"https://fbref.com/en/players/964f4f30/Marko-Ivezic"
2025,"Holstein Kiel","Bundesliga","Dominik Javorček","SVK","DF,MF","22-206",2002,4.3,3,0,3,0,0,1,5,20,4,7,3,4,5,8,26,1,"https://fbref.com/en/players/3a2cf67d/Dominik-Javorcek"
2025,"Holstein Kiel","Bundesliga","Carl Johansson","SWE","DF","31-004",1994,6.3,4,2,4,0,0,3,7,42.9,4,12,8,4,10,14,54,1,"https://fbref.com/en/players/02f7a79a/Carl-Johansson"
2025,"Holstein Kiel","Bundesliga","Andu Kelati","GER","MF,DF","22-287",2002,3.2,7,4,2,4,1,2,5,40,3,4,1,3,3,10,3,0,"https://fbref.com/en/players/58391f96/Andu-Kelati"
2025,"Holstein Kiel","Bundesliga","Magnus Knudsen","NOR","MF","23-346",2001,20.6,48,29,21,21,6,25,44,56.8,19,18,4,14,12,60,44,0,"https://fbref.com/en/players/a48fb0c7/Magnus-Knudsen"
2025,"Holstein Kiel","Bundesliga","Marco Komenda","CRO","DF","28-182",1996,14.5,26,17,12,13,1,11,15,73.3,4,23,11,12,6,32,68,0,"https://fbref.com/en/players/e7efcdb8/Marco-Komenda"
2025,"Holstein Kiel","Bundesliga","Shuto Machino","JPN","FW,MF","25-239",1999,21.7,8,5,4,3,1,6,16,37.5,10,12,3,9,7,15,28,1,"https://fbref.com/en/players/964dde35/Shuto-Machino"
2025,"Holstein Kiel","Bundesliga","Ivan Nekić","CRO","DF","24-154",2000,0.8,1,1,1,0,0,1,2,50,1,1,0,1,3,4,2,0,"https://fbref.com/en/players/d5656169/Ivan-Nekic"
2025,"Holstein Kiel","Bundesliga","Benedikt Pichler","AUT","FW","27-311",1997,8.7,5,2,1,0,4,2,4,50,2,4,2,2,2,7,11,0,"https://fbref.com/en/players/c184c8c8/Benedikt-Pichler"
2025,"Holstein Kiel","Bundesliga","Finn Porath","GER","DF,MF","28-093",1997,21.9,45,26,24,14,7,26,53,49.1,27,27,9,18,21,66,67,0,"https://fbref.com/en/players/b020d807/Finn-Porath"
2025,"Holstein Kiel","Bundesliga","Tymoteusz Puchacz","POL","DF","26-124",1999,4.4,9,4,6,3,0,5,7,71.4,2,4,1,3,3,12,11,0,"https://fbref.com/en/players/c68b1b13/Tymoteusz-Puchacz"
2025,"Holstein Kiel","Bundesliga","Nicolai Remberg","GER","MF","24-342",2000,26.9,45,25,24,17,4,19,41,46.3,22,46,20,26,29,74,100,0,"https://fbref.com/en/players/625fd441/Nicolai-Remberg"
2025,"Holstein Kiel","Bundesliga","Lasse Rosenboom","GER","DF","23-128",2002,19.3,47,35,25,16,6,32,47,68.1,15,28,9,19,19,66,71,3,"https://fbref.com/en/players/1df23153/Lasse-Rosenboom"
2025,"Holstein Kiel","Bundesliga","Marvin Schulz","GER","MF,DF","30-132",1995,3.4,6,5,2,2,2,2,8,25,6,12,8,4,0,6,17,0,"https://fbref.com/en/players/651167c8/Marvin-Schulz"
2025,"Holstein Kiel","Bundesliga","Steven Skrzybski","GER","MF,FW","32-190",1992,14.7,19,6,7,6,6,7,24,29.2,17,16,0,16,11,30,11,0,"https://fbref.com/en/players/58ce23e5/Steven-Skrzybski"
2025,"Holstein Kiel","Bundesliga","John Tolkin","USA","DF,MF","22-300",2002,8.2,18,11,11,7,0,12,14,85.7,2,10,2,8,8,26,54,0,"https://fbref.com/en/players/5e88c524/John-Tolkin"
2025,"Holstein Kiel","Bundesliga","Timon Weiner","GER","GK","26-129",1999,25,0,0,0,0,0,0,1,0,1,0,0,0,0,0,17,3,"https://fbref.com/en/players/1fb2d1b0/Timon-Weiner"
2025,"Holstein Kiel","Bundesliga","David Zec","SVN","DF","25-142",2000,17.1,23,10,17,6,0,13,20,65,7,32,18,14,17,40,93,3,"https://fbref.com/en/players/050cd03c/David-Zec"
2025,"Inter","Serie A","Francesco Acerbi","ITA","DF","37-106",1988,19,23,19,16,7,0,11,17,64.7,6,22,16,6,26,49,81,0,"https://fbref.com/en/players/b96b595c/Francesco-Acerbi"
2025,"Inter","Serie A","Marko Arnautović","AUT","FW","36-038",1989,6.1,7,6,1,3,3,3,5,60,2,3,0,3,1,8,1,0,"https://fbref.com/en/players/00459419/Marko-Arnautovic"
2025,"Inter","Serie A","Kristjan Asllani","ALB","MF","23-079",2002,11,14,3,8,4,2,8,22,36.4,14,8,1,7,9,23,13,1,"https://fbref.com/en/players/0fdcef0e/Kristjan-Asllani"
2025,"Inter","Serie A","Carlos Augusto","BRA","DF","26-140",1999,18.8,29,14,12,11,6,12,19,63.2,7,21,9,12,9,38,50,0,"https://fbref.com/en/players/8d3cd59d/Carlos-Augusto"
2025,"Inter","Serie A","Yann Aurel Bisseck","GER","DF","24-179",2000,18.3,17,12,11,4,2,11,16,68.8,5,23,12,11,17,34,64,1,"https://fbref.com/en/players/3963c25b/Yann-Aurel-Bisseck"
2025,"Inter","Serie A","Nicolò Barella","ITA","MF","28-109",1997,27.7,50,31,19,20,11,26,59,44.1,33,26,3,23,12,62,16,1,"https://fbref.com/en/players/6928979a/Nicolo-Barella"
2025,"Inter","Serie A","Alessandro Bastoni","ITA","DF","26-044",1999,26.7,46,24,26,14,6,20,30,66.7,10,25,13,12,22,68,52,1,"https://fbref.com/en/players/75b86fb3/Alessandro-Bastoni"
2025,"Inter","Serie A","Tajon Buchanan","CAN","DF,FW","26-108",1999,1.1,3,0,2,0,1,1,2,50,1,0,0,0,0,3,3,0,"https://fbref.com/en/players/3aca6420/Tajon-Buchanan"
2025,"Inter","Serie A","Hakan Çalhanoğlu","TUR","MF","31-108",1994,21.6,43,23,7,23,13,21,36,58.3,15,17,8,9,18,61,24,0,"https://fbref.com/en/players/cd0fa27b/Hakan-Calhanoglu"
2025,"Inter","Serie A","Joaquín Correa","ARG","FW,MF","30-287",1994,8.1,11,5,4,7,0,4,13,30.8,9,3,0,3,0,11,6,0,"https://fbref.com/en/players/45b9b619/Joaquin-Correa"
2025,"Inter","Serie A","Matteo Darmian","ITA","DF","35-176",1989,19.8,28,17,12,12,4,14,25,56,11,14,6,8,10,38,39,0,"https://fbref.com/en/players/96e0490d/Matteo-Darmian"
2025,"Inter","Serie A","Federico Dimarco","ITA","DF,FW","27-198",1997,24.2,25,14,10,12,3,10,19,52.6,9,24,4,20,14,39,33,2,"https://fbref.com/en/players/970b8574/Federico-Dimarco"
2025,"Inter","Serie A","Denzel Dumfries","NED","DF,FW","29-039",1996,21.7,25,18,12,9,4,14,27,51.9,13,31,8,23,6,31,26,1,"https://fbref.com/en/players/481c9ece/Denzel-Dumfries"
2025,"Inter","Serie A","Davide Frattesi","ITA","MF","25-217",1999,13.6,17,8,6,10,1,10,18,55.6,8,12,4,8,5,22,14,1,"https://fbref.com/en/players/2a7d27c1/Davide-Frattesi"
2025,"Inter","Serie A","Josep Martinez","ESP","GK","27-000",1998,5,0,0,0,0,0,0,0,NA,0,0,0,0,0,0,0,0,"https://fbref.com/en/players/11d8aff0/Josep-Martinez"
2025,"Inter","Serie A","Lautaro Martínez","ARG","FW","27-278",1997,28.5,30,16,10,12,8,13,25,52,12,21,3,18,10,40,15,0,"https://fbref.com/en/players/f7036e1c/Lautaro-Martinez"
2025,"Inter","Serie A","Henrikh Mkhitaryan","ARM","MF","36-126",1989,26.6,43,24,17,16,10,20,45,44.4,25,29,5,24,17,60,41,0,"https://fbref.com/en/players/dd0daf32/Henrikh-Mkhitaryan"
2025,"Inter","Serie A","Tomás Palacios","ARG","DF","22-029",2003,0.1,0,0,0,0,0,0,0,NA,0,0,0,0,1,1,0,0,"https://fbref.com/en/players/404101f9/Tomas-Palacios"
2025,"Inter","Serie A","Benjamin Pavard","FRA","DF","29-060",1996,17.6,29,16,12,12,5,18,25,72,7,16,12,4,16,45,52,0,"https://fbref.com/en/players/45a03961/Benjamin-Pavard"
2025,"Inter","Serie A","Yann Sommer","SUI","GK","36-161",1988,33,0,0,0,0,0,0,0,NA,0,0,0,0,0,0,13,1,"https://fbref.com/en/players/420c18a1/Yann-Sommer"
2025,"Inter","Serie A","Mehdi Taremi","IRN","FW","32-313",1992,9.1,7,1,2,2,3,1,4,25,3,11,2,9,0,7,11,0,"https://fbref.com/en/players/4c2a5d34/Mehdi-Taremi"
2025,"Inter","Serie A","Marcus Thuram","FRA","FW","27-294",1997,25.4,18,10,7,5,6,3,14,21.4,11,16,3,13,3,21,15,0,"https://fbref.com/en/players/6f8cd6d0/Marcus-Thuram"
2025,"Inter","Serie A","Luka Topalović","SVN","MF","19-093",2006,0.1,1,1,0,1,0,0,0,NA,0,0,0,0,0,1,0,0,"https://fbref.com/en/players/9a33c016/Luka-Topalovic"
2025,"Inter","Serie A","Stefan de Vrij","NED","DF","33-111",1992,19.2,18,12,12,5,1,9,12,75,3,19,11,8,23,41,89,0,"https://fbref.com/en/players/d0d8dd44/Stefan-de-Vrij"
2025,"Inter","Serie A","Nicola Zalewski","POL","DF,MF","23-124",2002,4.8,7,4,3,2,2,4,6,66.7,2,5,1,4,2,9,5,1,"https://fbref.com/en/players/45191c29/Nicola-Zalewski"
2025,"Inter","Serie A","Piotr Zieliński","POL","MF","31-007",1994,10.9,14,10,6,7,1,6,13,46.2,7,10,5,5,6,20,13,1,"https://fbref.com/en/players/a5296e55/Piotr-Zielinski"
2025,"Ipswich Town","Premier League","Nathan Broadhead","WAL","MF,FW","27-052",1998,7.8,9,4,3,6,0,3,12,25,9,8,1,7,4,13,5,0,"https://fbref.com/en/players/43309491/Nathan-Broadhead"
2025,"Ipswich Town","Premier League","Cameron Burgess","AUS","DF","29-218",1995,17.1,17,12,14,3,0,9,11,81.8,2,20,15,5,14,31,128,3,"https://fbref.com/en/players/da61ca98/Cameron-Burgess"
2025,"Ipswich Town","Premier League","Wes Burns","WAL","FW,DF","30-185",1994,10.3,13,11,1,9,3,4,10,40,6,7,2,5,10,23,13,2,"https://fbref.com/en/players/b3fe23c6/Wes-Burns"
2025,"Ipswich Town","Premier League","Jens Cajuste","SWE","MF","25-290",1999,21.8,44,22,19,23,2,21,49,42.9,28,25,10,15,28,72,33,2,"https://fbref.com/en/players/928a4a61/Jens-Cajuste"
2025,"Ipswich Town","Premier League","Conor Chaplin","ENG","MF,FW","28-100",1997,9.5,15,5,6,6,3,6,14,42.9,8,8,1,7,4,19,3,0,"https://fbref.com/en/players/4ec55b87/Conor-Chaplin"
2025,"Ipswich Town","Premier League","Harry Clarke","ENG","DF","24-086",2001,4.2,5,3,3,2,0,3,6,50,3,5,4,1,4,9,14,3,"https://fbref.com/en/players/a64f2573/Harry-Clarke"
2025,"Ipswich Town","Premier League","Jack Clarke","ENG","FW,MF","24-185",2000,13.1,32,20,11,10,11,17,34,50,17,9,0,9,7,39,29,2,"https://fbref.com/en/players/e16932d8/Jack-Clarke"
2025,"Ipswich Town","Premier League","Leif Davis","ENG","DF","25-135",2000,30.5,46,27,33,9,4,30,48,62.5,18,25,8,17,25,71,77,3,"https://fbref.com/en/players/8574c61f/Leif-Davis"
2025,"Ipswich Town","Premier League","Liam Delap","ENG","FW","22-108",2003,28.8,11,8,3,3,5,2,15,13.3,13,8,0,8,2,13,28,0,"https://fbref.com/en/players/dd897ee7/Liam-Delap"
2025,"Ipswich Town","Premier League","George Edmundson","ENG","DF","27-269",1997,0,0,0,0,0,0,0,0,NA,0,0,0,0,0,0,0,0,"https://fbref.com/en/players/46ff3923/George-Edmundson"
2025,"Ipswich Town","Premier League","Julio Enciso","PAR","MF,FW","21-124",2004,9.7,12,9,3,6,3,4,11,36.4,7,8,1,7,1,13,6,0,"https://fbref.com/en/players/9cfbad36/Julio-Enciso"
2025,"Ipswich Town","Premier League","Ben Godfrey","ENG","DF","27-132",1998,1.8,1,0,1,0,0,1,1,100,0,1,1,0,2,3,3,0,"https://fbref.com/en/players/9f7c837d/Ben-Godfrey"
2025,"Ipswich Town","Premier League","Jacob Greaves","ENG","DF","24-257",2000,24.5,40,21,20,17,3,22,35,62.9,13,41,26,15,21,61,148,3,"https://fbref.com/en/players/1f169636/Jacob-Greaves"
2025,"Ipswich Town","Premier League","Ali Al Hamadi","IRQ","FW","23-087",2002,1.5,1,0,0,0,1,0,2,0,2,0,0,0,0,1,2,0,"https://fbref.com/en/players/8450467d/Ali-Al-Hamadi"
2025,"Ipswich Town","Premier League","Marcus Harness","ENG","MF","29-092",1996,0.5,1,0,0,0,1,0,3,0,3,2,1,1,0,1,1,0,"https://fbref.com/en/players/90e9ca3d/Marcus-Harness"
2025,"Ipswich Town","Premier League","George Hirst","SCO","FW","26-101",1999,7.3,3,3,1,0,2,1,4,25,3,1,1,0,2,5,10,0,"https://fbref.com/en/players/78e87179/George-Hirst"
2025,"Ipswich Town","Premier League","Omari Hutchinson","ENG","MF,FW","21-209",2003,28.7,32,13,14,10,8,13,48,27.1,35,27,2,25,11,43,15,1,"https://fbref.com/en/players/bd9553e6/Omari-Hutchinson"
2025,"Ipswich Town","Premier League","Ben Johnson","ENG","DF,FW","25-123",2000,15,38,22,23,12,3,20,41,48.8,21,22,5,17,13,51,54,1,"https://fbref.com/en/players/9319781b/Ben-Johnson"
2025,"Ipswich Town","Premier League","Massimo Luongo","AUS","MF","32-244",1992,2.2,9,6,6,2,1,5,8,62.5,3,4,2,2,2,11,2,0,"https://fbref.com/en/players/967ac6e1/Massimo-Luongo"
2025,"Ipswich Town","Premier League","Sam Morsy","EGY","MF","33-259",1991,30.6,68,41,40,24,4,27,62,43.5,35,34,13,21,29,97,47,5,"https://fbref.com/en/players/a23c0949/Sam-Morsy"
2025,"Ipswich Town","Premier League","Arijanet Muric","KVX","GK","26-201",1998,18,0,0,0,0,0,0,2,0,2,0,0,0,0,0,10,5,"https://fbref.com/en/players/99aa1a84/Arijanet-Muric"
2025,"Ipswich Town","Premier League","Dara O'Shea","IRL","DF","26-084",1999,34.7,49,31,33,13,3,22,34,64.7,12,62,50,12,33,82,225,4,"https://fbref.com/en/players/1d042188/Dara-OShea"
2025,"Ipswich Town","Premier League","Chiedozie Ogbene","IRL","FW","28-026",1997,2.6,7,3,1,2,4,2,4,50,2,1,0,1,1,8,3,0,"https://fbref.com/en/players/788c0277/Chiedozie-Ogbene"
2025,"Ipswich Town","Premier League","Alex Palmer","ENG","GK","28-290",1996,13,0,0,0,0,0,0,0,NA,0,0,0,0,0,0,12,0,"https://fbref.com/en/players/6ea97fd5/Alex-Palmer"
2025,"Ipswich Town","Premier League","Kalvin Phillips","ENG","MF","29-176",1995,13.7,35,19,8,20,7,15,39,38.5,24,35,6,29,19,54,37,2,"https://fbref.com/en/players/4f565d77/Kalvin-Phillips"
2025,"Ipswich Town","Premier League","Jaden Philogene Bidace","ENG","FW,DF","23-108",2002,5.3,14,7,6,6,2,8,15,53.3,7,11,1,10,10,24,9,1,"https://fbref.com/en/players/19f4d211/Jaden-Philogene-Bidace"
2025,"Ipswich Town","Premier League","Sammie Szmodics","IRL","FW,MF","29-245",1995,11,16,10,4,10,2,7,26,26.9,19,10,2,8,6,22,14,0,"https://fbref.com/en/players/39944392/Sammie-Szmodics"
2025,"Ipswich Town","Premier League","Jack Taylor","IRL","MF","26-338",1998,9.6,20,10,6,11,3,12,27,44.4,15,12,3,9,9,29,24,0,"https://fbref.com/en/players/48eed8d5/Jack-Taylor"
2025,"Ipswich Town","Premier League","Conor Townsend","ENG","DF","32-084",1993,3.7,11,8,9,2,0,8,11,72.7,3,8,6,2,4,15,16,0,"https://fbref.com/en/players/4dc4f138/Conor-Townsend"
2025,"Ipswich Town","Premier League","Axel Tuanzebe","COD","DF","27-194",1997,19,31,19,21,4,6,17,26,65.4,9,21,10,11,23,54,56,1,"https://fbref.com/en/players/2baec6ce/Axel-Tuanzebe"
2025,"Ipswich Town","Premier League","Christian Walton","ENG","GK","29-199",1995,7,0,0,0,0,0,0,1,0,1,0,0,0,0,0,2,1,"https://fbref.com/en/players/c666574f/Christian-Walton"
2025,"Ipswich Town","Premier League","Luke Woolfenden","ENG","DF","26-218",1998,13.2,9,6,5,4,0,2,5,40,3,21,14,7,19,28,76,0,"https://fbref.com/en/players/e28e9bec/Luke-Woolfenden"
2025,"Juventus","Serie A","Vasilije Adžić","MNE","MF,FW","19-015",2006,0.5,2,2,0,1,1,0,1,0,1,0,0,0,0,2,0,0,"https://fbref.com/en/players/8b0f9fb8/Vasilije-Adzic"
2025,"Juventus","Serie A","Lorenzo Anghelè","ITA","FW","20-090",2005,0.1,0,0,0,0,0,0,0,NA,0,0,0,0,0,0,0,0,"https://fbref.com/en/players/b2f3d550/Lorenzo-Anghele"
2025,"Juventus","Serie A","Gleison Bremer","BRA","DF","28-070",1997,6,15,7,9,5,1,4,5,80,1,15,11,4,6,21,16,0,"https://fbref.com/en/players/5fd5ed86/Gleison-Bremer"
2025,"Juventus","Serie A","Andrea Cambiaso","ITA","DF,FW","25-096",2000,24.7,46,30,27,13,6,27,44,61.4,17,24,4,20,16,62,34,5,"https://fbref.com/en/players/247ed022/Andrea-Cambiaso"
2025,"Juventus","Serie A","Francisco Conceição","POR","FW,MF","22-164",2002,14.9,23,14,6,9,8,13,30,43.3,17,7,0,7,6,29,6,0,"https://fbref.com/en/players/5ef3d210/Francisco-Conceicao"
2025,"Juventus","Serie A","Alberto costa","POR","DF","21-240",2003,4,14,10,7,5,2,7,9,77.8,2,5,1,4,4,18,14,0,"https://fbref.com/en/players/4d36e5ae/Alberto-costa"
2025,"Juventus","Serie A","Danilo","BRA","DF","33-316",1991,6.5,10,4,7,2,1,5,10,50,5,4,3,1,9,19,21,1,"https://fbref.com/en/players/94b2001f/Danilo"
2025,"Juventus","Serie A","Juan David Cabal","COL","DF","24-139",2001,5.1,10,4,7,3,0,8,12,66.7,4,2,0,2,2,12,14,1,"https://fbref.com/en/players/ef6eef89/Juan-David-Cabal"
2025,"Juventus","Serie A","Michele Di Gregorio","ITA","GK","27-304",1997,33,0,0,0,0,0,0,0,NA,0,0,0,0,1,1,14,0,"https://fbref.com/en/players/4e0c8d66/Michele-Di-Gregorio"
2025,"Juventus","Serie A","Nicolò Fagioli","ITA","MF","24-104",2001,6.3,14,10,7,6,1,6,9,66.7,3,4,0,4,2,16,5,0,"https://fbref.com/en/players/366be751/Nicolo-Fagioli"
2025,"Juventus","Serie A","Federico Gatti","ITA","DF","26-337",1998,24.4,28,23,18,8,2,14,24,58.3,10,27,18,9,18,46,76,2,"https://fbref.com/en/players/18dd3219/Federico-Gatti"
2025,"Juventus","Serie A","Nicolás González","ARG","FW,MF","27-051",1998,19.4,24,13,10,9,5,9,25,36,16,16,4,12,9,33,37,2,"https://fbref.com/en/players/2374aaca/Nicolas-Gonzalez"
2025,"Juventus","Serie A","Pierre Kalulu","FRA","DF","24-356",2000,26,41,25,29,9,3,18,24,75,6,27,15,12,17,58,68,1,"https://fbref.com/en/players/85f7d1be/Pierre-Kalulu"
2025,"Juventus","Serie A","Lloyd Kelly","ENG","DF","26-233",1998,11.3,15,11,5,9,1,7,9,77.8,2,11,6,5,2,17,56,3,"https://fbref.com/en/players/f31def1e/Lloyd-Kelly"
2025,"Juventus","Serie A","Randal Kolo Muani","FRA","FW","26-173",1998,12.9,11,7,3,5,3,4,5,80,1,8,0,8,4,15,2,0,"https://fbref.com/en/players/c0b3669f/Randal-Kolo-Muani"
2025,"Juventus","Serie A","Teun Koopmeiners","NED","MF,FW","27-088",1998,22.2,32,16,6,19,7,10,30,33.3,20,36,14,22,8,40,26,2,"https://fbref.com/en/players/a26fb8aa/Teun-Koopmeiners"
2025,"Juventus","Serie A","Manuel Locatelli","ITA","MF","27-139",1998,31.4,72,49,29,35,8,32,56,57.1,24,58,20,38,23,95,77,0,"https://fbref.com/en/players/a8a874f1/Manuel-Locatelli"
2025,"Juventus","Serie A","Douglas Luiz","BRA","MF","27-018",1998,5.9,13,8,7,5,1,6,9,66.7,3,5,2,3,4,17,5,0,"https://fbref.com/en/players/6f7d826d/Douglas-Luiz"
2025,"Juventus","Serie A","Samuel Mbangula","BEL","FW","21-131",2004,7.9,15,10,7,6,2,7,13,53.8,6,7,0,7,3,18,4,0,"https://fbref.com/en/players/3e25e70c/Samuel-Mbangula"
2025,"Juventus","Serie A","Weston McKennie","USA","MF,DF","26-272",1998,25.7,33,12,18,11,4,13,22,59.1,9,28,8,20,14,47,37,0,"https://fbref.com/en/players/01c3aff5/Weston-McKennie"
2025,"Juventus","Serie A","Mattia Perin","ITA","GK","32-198",1992,5,0,0,0,0,0,0,0,NA,0,0,0,0,0,0,2,0,"https://fbref.com/en/players/4c62d0c8/Mattia-Perin"
2025,"Juventus","Serie A","Diego Pugno","ITA","FW","18-324",2006,0.1,0,0,0,0,0,0,0,NA,0,0,0,0,0,0,0,0,"https://fbref.com/en/players/e4b616dc/Diego-Pugno"
2025,"Juventus","Serie A","Jonas Rouhi","SWE","DF","21-140",2004,2.3,4,1,1,3,0,0,1,0,1,2,0,2,3,7,2,0,"https://fbref.com/en/players/31908a0a/Jonas-Rouhi"
2025,"Juventus","Serie A","Nicolò Savona","ITA","DF","22-069",2003,19.2,29,13,19,9,1,13,25,52,12,12,3,9,11,40,38,0,"https://fbref.com/en/players/e041497d/Nicolo-Savona"
2025,"Juventus","Serie A","Khéphren Thuram","FRA","MF","24-062",2001,25.8,44,21,16,24,4,18,32,56.3,14,32,10,22,14,58,39,2,"https://fbref.com/en/players/7d9397f8/Khephren-Thuram"
2025,"Juventus","Serie A","Renato Veiga","POR","DF","21-302",2003,12.1,17,12,7,9,1,9,14,64.3,5,17,13,4,19,36,81,0,"https://fbref.com/en/players/fc8fcbd1/Renato-Veiga"
2025,"Juventus","Serie A","Dušan Vlahović","SRB","FW","25-119",2000,19.8,4,2,0,1,3,1,5,20,4,7,3,4,1,5,9,3,"https://fbref.com/en/players/79443529/Dusan-Vlahovic"
2025,"Juventus","Serie A","Timothy Weah","USA","DF,FW","25-094",2000,18.2,36,19,15,13,8,14,25,56,11,25,4,21,14,50,27,2,"https://fbref.com/en/players/8eec784d/Timothy-Weah"
2025,"Juventus","Serie A","Kenan Yıldız","TUR","FW,MF","20-023",2005,26.7,54,30,13,26,15,18,32,56.3,14,25,0,25,5,59,13,3,"https://fbref.com/en/players/d8cda243/Kenan-Yildiz"
2025,"Las Palmas","La Liga","Stefan Bajcetic","ESP","MF,DF","20-217",2004,10.8,29,14,13,13,3,12,28,42.9,16,25,4,21,15,44,26,1,"https://fbref.com/en/players/32e8417f/Stefan-Bajcetic"
2025,"Las Palmas","La Liga","Aboubacar Bassinga","CIV","MF","19-318",2005,0,0,0,0,0,0,0,0,NA,0,0,0,0,0,0,0,0,"https://fbref.com/en/players/22a312ec/Aboubacar-Bassinga"
2025,"Las Palmas","La Liga","José Campaña","ESP","MF","31-361",1993,13.2,21,16,8,11,2,11,20,55,9,9,1,8,19,40,19,2,"https://fbref.com/en/players/61220da2/Jose-Campana"
2025,"Las Palmas","La Liga","Marc Cardona","ESP","FW,DF","29-323",1995,1.5,4,2,1,3,0,0,1,0,1,0,0,0,0,4,0,0,"https://fbref.com/en/players/b92b456a/Marc-Cardona"
2025,"Las Palmas","La Liga","José Carlos González","ESP","DF","19-061",2006,0.1,0,0,0,0,0,0,0,NA,0,0,0,0,0,0,0,0,"https://fbref.com/en/players/79fe48ae/Jose-Carlos-Gonzalez"
2025,"Las Palmas","La Liga","Jasper Cillessen","NED","GK","36-035",1989,25.9,1,0,1,0,0,1,4,25,3,0,0,0,0,1,11,2,"https://fbref.com/en/players/04ac8285/Jasper-Cillessen"
2025,"Las Palmas","La Liga","Dario Essugo","POR","MF","20-074",2005,21.5,59,45,28,26,5,28,46,60.9,18,28,11,17,42,101,47,7,"https://fbref.com/en/players/1e4319ac/Dario-Essugo"
2025,"Las Palmas","La Liga","Manuel Fuster","ESP","FW,MF","27-217",1997,11.1,19,11,5,8,6,15,28,53.6,13,13,3,10,4,23,17,0,"https://fbref.com/en/players/618f396a/Manuel-Fuster"
2025,"Las Palmas","La Liga","Fabio González","ESP","MF","28-104",1997,0.6,0,0,0,0,0,0,1,0,1,0,0,0,0,0,0,0,"https://fbref.com/en/players/5418d47c/Fabio-Gonzalez"
2025,"Las Palmas","La Liga","Juan Herzog","ESP","DF","22-014",2003,14.6,12,12,12,0,0,9,16,56.3,7,17,11,6,18,30,86,0,"https://fbref.com/en/players/3a18abe2/Juan-Herzog"
2025,"Las Palmas","La Liga","Dinko Horkaš","CRO","GK","26-078",1999,12.1,0,0,0,0,0,0,0,NA,0,0,0,0,0,0,9,1,"https://fbref.com/en/players/8fafc04d/Dinko-Horkas"
2025,"Las Palmas","La Liga","Adnan Januzaj","BEL","MF,FW","30-111",1995,6.6,10,6,1,6,3,5,9,55.6,4,6,0,6,2,12,3,0,"https://fbref.com/en/players/4737cebe/Adnan-Januzaj"
2025,"Las Palmas","La Liga","Enzo Loiodice","FRA","MF","24-181",2000,7.6,17,7,8,9,0,3,10,30,7,4,1,3,10,27,7,2,"https://fbref.com/en/players/6bca20fe/Enzo-Loiodice"
2025,"Las Palmas","La Liga","Mika Mármol","ESP","DF","23-330",2001,26.7,61,29,35,24,2,34,52,65.4,18,46,14,32,38,99,121,2,"https://fbref.com/en/players/e7630876/Mika-Marmol"
2025,"Las Palmas","La Liga","Diego Martín","ESP","FW","21-287",2003,0.4,1,1,0,0,1,1,1,100,0,0,0,0,0,1,1,0,"https://fbref.com/en/players/db28ad66/Diego-Martin"
2025,"Las Palmas","La Liga","Marvin","ESP","DF,FW","24-328",2000,11.5,25,13,12,9,4,11,26,42.3,15,17,6,11,15,40,34,0,"https://fbref.com/en/players/efaefda0/Marvin"
2025,"Las Palmas","La Liga","Jaime Mata","ESP","FW,MF","36-215",1988,7.3,8,2,2,6,0,3,9,33.3,6,5,1,4,3,11,11,0,"https://fbref.com/en/players/02319ad7/Jaime-Mata"
2025,"Las Palmas","La Liga","Oliver McBurnie","SCO","FW","28-357",1996,20.4,15,7,5,8,2,5,12,41.7,7,15,5,10,6,21,24,0,"https://fbref.com/en/players/78b8ac63/Oliver-McBurnie"
2025,"Las Palmas","La Liga","Scott McKenna","SCO","DF","28-196",1996,27.4,21,13,16,5,0,9,12,75,3,36,28,8,9,30,163,2,"https://fbref.com/en/players/4e5a4cbc/Scott-McKenna"
2025,"Las Palmas","La Liga","Alberto Moleiro","ESP","FW,MF","21-239",2003,30.2,27,12,12,14,1,18,48,37.5,30,24,0,24,18,45,8,0,"https://fbref.com/en/players/c2c8897d/Alberto-Moleiro"
2025,"Las Palmas","La Liga","Álex Muñoz","ESP","DF","30-301",1994,15.7,39,29,22,16,1,21,38,55.3,17,28,11,17,16,55,69,0,"https://fbref.com/en/players/853f211e/Alex-Munoz"
2025,"Las Palmas","La Liga","Javier Muñoz","ESP","MF,DF","30-088",1995,28.8,45,35,18,17,10,16,46,34.8,30,27,4,23,31,76,39,3,"https://fbref.com/en/players/ec7c84c2/Javier-Munoz"
2025,"Las Palmas","La Liga","Pejiño","ESP","FW","28-302",1996,0.2,1,1,0,1,0,1,1,100,0,0,0,0,0,1,0,0,"https://fbref.com/en/players/8c4e56cb/Pejino"
2025,"Las Palmas","La Liga","Andy Pelmard","FRA","DF","25-076",2000,2.3,5,0,3,2,0,4,5,80,1,3,1,2,2,7,20,0,"https://fbref.com/en/players/f18d7ab2/Andy-Pelmard"
2025,"Las Palmas","La Liga","Valentín Pezzolesi","ESP","DF","18-041",2007,0.1,0,0,0,0,0,0,0,NA,0,0,0,0,0,0,1,1,"https://fbref.com/en/players/06d00fbd/Valentin-Pezzolesi"
2025,"Las Palmas","La Liga","Benito Ramírez","ESP","DF,FW","29-320",1995,5.3,10,5,4,6,0,9,16,56.3,7,8,3,5,1,11,14,1,"https://fbref.com/en/players/db714daf/Benito-Ramirez"
2025,"Las Palmas","La Liga","Sandro Ramírez","ESP","FW,MF","29-322",1995,22.6,27,15,10,13,4,13,30,43.3,17,20,0,20,16,43,22,2,"https://fbref.com/en/players/833fb62e/Sandro-Ramirez"
2025,"Las Palmas","La Liga","Arturo Rodríguez","ESP","FW","18-295",2006,0.2,0,0,0,0,0,0,0,NA,0,0,0,0,0,0,0,0,"https://fbref.com/en/players/8516f382/Arturo-Rodriguez"
2025,"Las Palmas","La Liga","Kirian Rodríguez","ESP","MF","29-083",1996,19.5,33,17,12,18,3,22,43,51.2,21,22,4,18,10,43,21,0,"https://fbref.com/en/players/9b130479/Kirian-Rodriguez"
2025,"Las Palmas","La Liga","Fábio Silva","POR","FW","22-312",2002,20.7,12,7,4,5,3,4,14,28.6,10,12,0,12,4,16,27,0,"https://fbref.com/en/players/e7aa9d7c/Fabio-Silva"
2025,"Las Palmas","La Liga","Daley Sinkgraven","NED","DF","29-327",1995,1,5,1,3,2,0,1,3,33.3,2,1,0,1,1,6,2,0,"https://fbref.com/en/players/73000a79/Daley-Sinkgraven"
2025,"Las Palmas","La Liga","Álex Suárez","ESP","DF","32-070",1993,27.3,40,23,30,9,1,20,27,74.1,7,39,24,15,13,53,107,2,"https://fbref.com/en/players/9c137b36/Alex-Suarez"
2025,"Las Palmas","La Liga","Sergio Viera","ESP","MF","20-019",2005,1.1,1,1,0,1,0,0,1,0,1,1,0,1,1,2,1,0,"https://fbref.com/en/players/36b300b8/Sergio-Viera"
2025,"Las Palmas","La Liga","Viti","ESP","DF","27-253",1997,22,71,46,43,21,7,31,45,68.9,14,28,7,21,27,98,61,0,"https://fbref.com/en/players/c56a2d27/Viti"
2025,"Lazio","Serie A","Reda Belahyane","MAR","MF","20-360",2004,2.2,8,6,8,0,0,6,6,100,0,3,2,1,1,9,5,0,"https://fbref.com/en/players/705a1642/Reda-Belahyane"
2025,"Lazio","Serie A","Nicolò Casale","ITA","DF","27-102",1998,1.5,5,3,4,1,0,0,0,NA,0,4,3,1,1,6,2,0,"https://fbref.com/en/players/3f5f38fb/Nicolo-Casale"
2025,"Lazio","Serie A","Valentín Castellanos","ARG","FW","26-236",1998,26.5,13,6,2,4,7,1,10,10,9,18,2,16,6,19,25,0,"https://fbref.com/en/players/da76bab4/Valentin-Castellanos"
2025,"Lazio","Serie A","Gaetano Castrovilli","ITA","MF,FW","28-099",1997,1.6,5,2,3,1,1,2,4,50,2,3,0,3,3,8,1,0,"https://fbref.com/en/players/0728bebe/Gaetano-Castrovilli"
2025,"Lazio","Serie A","Fisayo Dele-Bashiru","NGA","MF,FW","24-110",2001,10.5,10,6,3,3,4,2,6,33.3,4,10,2,8,4,14,5,0,"https://fbref.com/en/players/121a4fb8/Fisayo-Dele-Bashiru"
2025,"Lazio","Serie A","Boulaye Dia","SEN","MF,FW","28-192",1996,24.2,22,10,5,12,5,7,16,43.8,9,12,1,11,6,28,16,1,"https://fbref.com/en/players/244bc2c8/Boulaye-Dia"
2025,"Lazio","Serie A","Samuel Gigot","FRA","DF","31-227",1993,7.6,4,3,1,3,0,0,1,0,1,8,6,2,13,17,36,0,"https://fbref.com/en/players/41eebdf5/Samuel-Gigot"
2025,"Lazio","Serie A","Mario Gila","ESP","DF","24-271",2000,30.5,55,37,35,18,2,37,56,66.1,19,20,13,7,28,83,115,4,"https://fbref.com/en/players/9c435456/Mario-Gila"
2025,"Lazio","Serie A","Mattéo Guendouzi","FRA","MF","26-043",1999,36.3,37,21,13,19,5,20,47,42.6,27,34,9,25,32,69,50,2,"https://fbref.com/en/players/5ea8ef20/Matteo-Guendouzi"
2025,"Lazio","Serie A","Elseid Hysaj","ALB","DF","31-096",1994,4.7,11,6,6,5,0,3,3,100,0,5,2,3,5,16,21,0,"https://fbref.com/en/players/2f3452eb/Elseid-Hysaj"
2025,"Lazio","Serie A","Arijon Ibrahimović","GER","MF","19-167",2005,0.1,0,0,0,0,0,0,0,NA,0,0,0,0,0,0,0,0,"https://fbref.com/en/players/f5c4fd91/Arijon-Ibrahimovic"
2025,"Lazio","Serie A","Gustav Isaksen","DEN","FW","24-038",2001,24.6,16,9,7,8,1,7,28,25,21,22,2,20,10,26,21,1,"https://fbref.com/en/players/5715bb71/Gustav-Isaksen"
2025,"Lazio","Serie A","Manuel Lazzari","ITA","DF","31-179",1993,15.6,26,16,13,11,2,14,24,58.3,10,9,5,4,10,36,19,0,"https://fbref.com/en/players/02caf6e0/Manuel-Lazzari"
2025,"Lazio","Serie A","Christos Mandas","GRE","GK","23-252",2001,9,0,0,0,0,0,0,0,NA,0,0,0,0,0,0,4,0,"https://fbref.com/en/players/f794e9ab/Christos-Mandas"
2025,"Lazio","Serie A","Adam Marušić","MNE","DF","32-222",1992,26,32,20,18,12,2,18,30,60,12,18,8,10,16,48,61,0,"https://fbref.com/en/players/d4535821/Adam-Marusic"
2025,"Lazio","Serie A","Oliver Nielsen","DEN","DF","21-357",2003,0.4,0,0,0,0,0,0,0,NA,0,1,0,1,1,1,2,0,"https://fbref.com/en/players/e97adead/Oliver-Nielsen"
2025,"Lazio","Serie A","Tijjani Noslin","NED","FW,MF","25-324",1999,9.6,6,5,2,1,3,1,8,12.5,7,15,1,14,1,7,7,0,"https://fbref.com/en/players/2f067cf2/Tijjani-Noslin"
2025,"Lazio","Serie A","Patric","ESP","DF","32-040",1993,6.7,9,6,6,3,0,6,10,60,4,3,2,1,3,12,22,1,"https://fbref.com/en/players/f7223718/Patric"
2025,"Lazio","Serie A","Pedro","ESP","FW,MF","37-303",1987,12.2,19,14,5,9,5,10,21,47.6,11,11,0,11,3,22,3,1,"https://fbref.com/en/players/3ca7254a/Pedro"
2025,"Lazio","Serie A","Luca Pellegrini","ITA","DF","26-081",1999,11.9,23,11,11,10,2,17,32,53.1,15,10,3,7,19,42,32,0,"https://fbref.com/en/players/3b61c9ec/Luca-Pellegrini"
2025,"Lazio","Serie A","Ivan Provedel","ITA","GK","31-071",1994,29,0,0,0,0,0,0,0,NA,0,1,0,1,1,1,12,3,"https://fbref.com/en/players/277da414/Ivan-Provedel"
2025,"Lazio","Serie A","Alessio Romagnoli","ITA","DF","30-135",1995,29.7,48,29,20,26,2,22,27,81.5,5,33,17,16,26,74,118,1,"https://fbref.com/en/players/3ead85f9/Alessio-Romagnoli"
2025,"Lazio","Serie A","Nicolò Rovella","ITA","MF","23-174",2001,30.2,84,50,39,38,7,41,79,51.9,38,19,4,15,47,131,46,3,"https://fbref.com/en/players/e58cbfd5/Nicolo-Rovella"
2025,"Lazio","Serie A","Nuno Tavares","POR","DF","25-121",2000,18.7,28,21,15,8,5,14,34,41.2,20,21,3,18,21,49,44,2,"https://fbref.com/en/players/a65c844b/Nuno-Tavares"
2025,"Lazio","Serie A","Loum Tchaouna","FRA","FW,MF","21-261",2003,7.3,8,4,2,2,4,3,9,33.3,6,5,1,4,4,12,14,2,"https://fbref.com/en/players/a3c8b4d3/Loum-Tchaouna"
2025,"Lazio","Serie A","Matías Vecino","URU","MF","33-276",1991,9.7,13,7,3,9,1,4,18,22.2,14,9,3,6,5,18,15,0,"https://fbref.com/en/players/44ac04e9/Matias-Vecino"
2025,"Lazio","Serie A","Mattia Zaccagni","ITA","FW","29-345",1995,29.8,38,27,13,21,4,16,32,50,16,19,1,18,29,67,22,2,"https://fbref.com/en/players/d85c238b/Mattia-Zaccagni"
2025,"Le Havre","Ligue 1","André Ayew","GHA","FW","35-161",1989,16.1,18,10,3,7,8,7,13,53.8,6,9,2,7,3,21,21,1,"https://fbref.com/en/players/5dbefa9d/Andre-Ayew"
2025,"Le Havre","Ligue 1","Fodé Ballo-Touré","SEN","DF,MF","28-144",1997,6.5,8,7,3,4,1,5,9,55.6,4,8,3,5,4,12,27,0,"https://fbref.com/en/players/f449640d/Fode-Ballo-Toure"
2025,"Le Havre","Ligue 1","Mathéo Bodmer","FRA","MF","21-021",2004,0.1,0,0,0,0,0,0,0,NA,0,0,0,0,0,0,1,0,"https://fbref.com/en/players/c4c45a88/Matheo-Bodmer"
2025,"Le Havre","Ligue 1","Josué Casimir","FRA","FW,MF","23-245",2001,22.2,37,26,15,15,7,9,18,50,9,19,0,19,7,44,35,1,"https://fbref.com/en/players/481f76cf/Josue-Casimir"
2025,"Le Havre","Ligue 1","Alois Confais","FRA","MF","28-262",1996,0,0,0,0,0,0,0,0,NA,0,0,0,0,0,0,0,0,"https://fbref.com/en/players/535b0343/Alois-Confais"
2025,"Le Havre","Ligue 1","Arthur Desmas","FRA","GK","31-050",1994,18,0,0,0,0,0,0,1,0,1,0,0,0,0,0,9,1,"https://fbref.com/en/players/e8c5dd4d/Arthur-Desmas"
2025,"Le Havre","Ligue 1","Kandet Diawara","GUI","FW","25-106",2000,0,0,0,0,0,0,0,0,NA,0,1,0,1,0,0,1,0,"https://fbref.com/en/players/1f038218/Kandet-Diawara"
2025,"Le Havre","Ligue 1","Mahamadou Diawara","FRA","MF","20-099",2005,6.5,20,12,10,8,2,8,13,61.5,5,13,6,7,13,33,11,1,"https://fbref.com/en/players/1906b842/Mahamadou-Diawara"
2025,"Le Havre","Ligue 1","Mathieu Gorgelin","FRA","GK","34-295",1990,16,2,2,2,0,0,2,3,66.7,1,0,0,0,0,2,8,2,"https://fbref.com/en/players/4d3e9033/Mathieu-Gorgelin"
2025,"Le Havre","Ligue 1","Samuel Grandsir","FRA","MF,FW","28-286",1996,0.9,5,5,0,3,2,2,3,66.7,1,2,0,2,0,5,0,0,"https://fbref.com/en/players/d2448564/Samuel-Grandsir"
2025,"Le Havre","Ligue 1","Ilyes Housni","FRA","FW,MF","20-013",2005,2.6,7,5,2,3,2,2,4,50,2,2,0,2,1,8,2,0,"https://fbref.com/en/players/910e3cad/Ilyes-Housni"
2025,"Le Havre","Ligue 1","Antoine Joujou","FRA","MF,FW","22-076",2003,10.5,16,11,10,4,2,9,15,60,6,15,3,12,9,25,19,0,"https://fbref.com/en/players/f9124307/Antoine-Joujou"
2025,"Le Havre","Ligue 1","Yassine Kechta","MAR","MF,FW","23-091",2002,23.3,60,36,32,21,7,33,78,42.3,45,25,2,23,26,86,32,2,"https://fbref.com/en/players/abefc3af/Yassine-Kechta"
2025,"Le Havre","Ligue 1","Koka","EGY","FW","32-083",1993,9.5,4,1,1,3,0,0,4,0,4,3,0,3,4,8,6,1,"https://fbref.com/en/players/9fc2531b/Koka"
2025,"Le Havre","Ligue 1","Daler Kuzyaev","RUS","MF","32-132",1993,6.3,13,8,7,4,2,2,9,22.2,7,7,4,3,9,22,8,0,"https://fbref.com/en/players/d4e93bab/Daler-Kuzyaev"
2025,"Le Havre","Ligue 1","Gautier Lloris","FRA","DF","29-313",1995,30.8,68,43,52,16,0,38,53,71.7,15,33,21,12,34,102,192,0,"https://fbref.com/en/players/ac89503b/Gautier-Lloris"
2025,"Le Havre","Ligue 1","Elysée Logbo","FRA","FW","21-021",2004,0.3,0,0,0,0,0,0,0,NA,0,0,0,0,0,0,0,0,"https://fbref.com/en/players/daa11a4f/Elysee-Logbo"
2025,"Le Havre","Ligue 1","Junior Mwanga","FRA","MF","22-016",2003,10.6,26,16,10,13,3,11,19,57.9,8,10,3,7,8,34,18,2,"https://fbref.com/en/players/ee158be5/Junior-Mwanga"
2025,"Le Havre","Ligue 1","Rassoul Ndiaye","SEN","MF","23-167",2001,11.8,35,25,19,12,4,11,25,44,14,15,4,11,12,47,24,0,"https://fbref.com/en/players/36f65bdf/Rassoul-Ndiaye"
2025,"Le Havre","Ligue 1","Loïc Nego","HUN","DF,FW","34-132",1991,27.3,58,35,37,16,5,41,64,64.1,23,17,3,14,29,87,82,0,"https://fbref.com/en/players/c3b6fa1e/Loic-Nego"
2025,"Le Havre","Ligue 1","Steve Ngoura","FRA","FW","20-094",2005,3.2,4,2,1,1,2,3,3,100,0,2,1,1,0,4,2,0,"https://fbref.com/en/players/731f1f5a/Steve-Ngoura"
2025,"Le Havre","Ligue 1","Christopher Operi","CIV","DF,FW","28-028",1997,13,13,9,6,2,5,7,12,58.3,5,20,6,14,14,27,30,0,"https://fbref.com/en/players/914bb955/Christopher-Operi"
2025,"Le Havre","Ligue 1","Timothee Pembele","FRA","DF","22-260",2002,12.4,30,22,17,9,4,14,23,60.9,9,16,5,11,11,41,42,0,"https://fbref.com/en/players/f8ce97ca/Timothee-Pembele"
2025,"Le Havre","Ligue 1","Emmanuel Sabbi","USA","FW,MF","27-154",1997,7.3,14,7,7,4,3,5,8,62.5,3,2,0,2,3,17,4,0,"https://fbref.com/en/players/2e1b7c83/Emmanuel-Sabbi"
2025,"Le Havre","Ligue 1","Yoann Salmier","GUF","DF","32-187",1992,8.9,14,7,9,4,1,10,13,76.9,3,12,8,4,10,24,59,0,"https://fbref.com/en/players/c3725db2/Yoann-Salmier"
2025,"Le Havre","Ligue 1","Arouna Sangante","SEN","DF","23-045",2002,13.8,25,16,11,14,0,10,17,58.8,7,11,5,6,21,46,65,3,"https://fbref.com/en/players/17bb562c/Arouna-Sangante"
2025,"Le Havre","Ligue 1","Issa Soumaré","SEN","FW,MF","24-229",2000,21.1,25,14,8,10,7,13,49,26.5,36,19,4,15,16,41,32,0,"https://fbref.com/en/players/1d8aa290/Issa-Soumare"
2025,"Le Havre","Ligue 1","Oussama Targhalline","MAR","MF","23-007",2002,11,19,14,12,3,4,5,12,41.7,7,14,7,7,19,38,14,2,"https://fbref.com/en/players/abd56820/Oussama-Targhalline"
2025,"Le Havre","Ligue 1","Abdoulaye Touré","GUI","MF","31-085",1994,25.8,61,34,31,21,9,33,59,55.9,26,36,19,17,34,95,42,5,"https://fbref.com/en/players/ef7cd87a/Abdoulaye-Toure"
2025,"Le Havre","Ligue 1","Etienne Youte Kinkoue","FRA","DF","23-133",2002,25.8,19,10,11,7,1,13,20,65,7,36,23,13,29,48,158,3,"https://fbref.com/en/players/12a4e38c/Etienne-Youte-Kinkoue"
2025,"Le Havre","Ligue 1","Yanis Zouaoui","ALG","DF,FW","30-321",1994,10.8,20,10,10,8,2,11,15,73.3,4,15,2,13,8,28,43,0,"https://fbref.com/en/players/ec724366/Yanis-Zouaoui"
2025,"Lecce","Serie A","Lameck Banda","ZAM","FW,MF","24-118",2001,6.8,8,5,4,2,2,3,12,25,9,7,0,7,2,10,8,1,"https://fbref.com/en/players/8a6de8c7/Lameck-Banda"
2025,"Lecce","Serie A","Federico Baschirotto","ITA","DF","28-249",1996,38,37,25,30,5,2,22,28,78.6,6,44,32,12,23,60,237,2,"https://fbref.com/en/players/5a08ee41/Federico-Baschirotto"
2025,"Lecce","Serie A","Medon Berisha","ALB","MF","21-218",2003,8,12,8,7,3,2,4,8,50,4,6,0,6,11,23,5,2,"https://fbref.com/en/players/9d376bef/Medon-Berisha"
2025,"Lecce","Serie A","Kevin Bonifazi","ITA","DF","29-008",1996,0.7,1,1,1,0,0,1,1,100,0,1,1,0,2,3,3,0,"https://fbref.com/en/players/fb77bfef/Kevin-Bonifazi"
2025,"Lecce","Serie A","Rareș-Cătălin Burnete","ROU","FW","21-116",2004,0.3,0,0,0,0,0,0,1,0,1,0,0,0,0,0,0,0,"https://fbref.com/en/players/7c4b4e36/Rares-Catalin-Burnete"
2025,"Lecce","Serie A","Lassana Coulibaly","MLI","MF","29-047",1996,29.6,48,29,16,28,4,24,61,39.3,37,45,12,33,18,66,46,1,"https://fbref.com/en/players/85a44ecc/Lassana-Coulibaly"
2025,"Lecce","Serie A","Patrick Dorgu","DEN","DF,FW","20-213",2004,20.4,45,27,21,19,5,23,45,51.1,22,24,6,18,18,63,42,2,"https://fbref.com/en/players/e6536124/Patrick-Dorgu"
2025,"Lecce","Serie A","Wladimiro Falcone","ITA","GK","30-045",1995,38,0,0,0,0,0,0,0,NA,0,0,0,0,0,0,29,3,"https://fbref.com/en/players/9f5a610b/Wladimiro-Falcone"
2025,"Lecce","Serie A","Tiago Gabriel","POR","DF","20-152",2004,1.1,0,0,0,0,0,0,0,NA,0,4,2,2,0,0,11,0,"https://fbref.com/en/players/19452285/Tiago-Gabriel"
2025,"Lecce","Serie A","Antonino Gallo","ITA","DF","25-142",2000,29,65,42,46,15,4,34,62,54.8,28,33,6,27,20,85,133,0,"https://fbref.com/en/players/c74d63ac/Antonino-Gallo"
2025,"Lecce","Serie A","Valentin Gendrey","FRA","DF","24-340",2000,2,2,2,1,0,1,1,1,100,0,3,1,2,2,4,1,0,"https://fbref.com/en/players/822ed0ec/Valentin-Gendrey"
2025,"Lecce","Serie A","Frederic Guilbert","FRA","DF","30-154",1994,27.1,65,36,30,29,6,36,55,65.5,19,28,8,20,47,112,113,3,"https://fbref.com/en/players/5d8d7454/Frederic-Guilbert"
2025,"Lecce","Serie A","Gaby Jean","FRA","DF","25-097",2000,15.4,14,7,8,5,1,6,11,54.5,5,13,10,3,9,23,71,1,"https://fbref.com/en/players/5f130a19/Gaby-Jean"
2025,"Lecce","Serie A","Þórir Jóhann Helgason","ISL","MF","24-241",2000,12.8,10,7,3,6,1,7,13,53.8,6,7,2,5,6,16,11,2,"https://fbref.com/en/players/dc765618/Thorir-Johann-Helgason"
2025,"Lecce","Serie A","Mohamed Kaba","FRA","MF","23-212",2001,5,13,8,7,5,1,8,10,80,2,11,4,7,4,17,10,1,"https://fbref.com/en/players/517cfb19/Mohamed-Kaba"
2025,"Lecce","Serie A","Jesper Karlsson","SWE","FW","26-306",1998,5.5,3,2,3,0,0,2,8,25,6,2,0,2,0,3,4,0,"https://fbref.com/en/players/7952d0c2/Jesper-Karlsson"
2025,"Lecce","Serie A","Kialonda","ANG","DF","27-242",1997,23.8,34,12,24,10,0,12,17,70.6,5,44,28,16,32,66,132,1,"https://fbref.com/en/players/34e4dc3b/Kialonda"
2025,"Lecce","Serie A","Nikola Krstović","MNE","FW","25-052",2000,34,18,9,4,7,7,7,16,43.8,9,12,7,5,7,25,24,0,"https://fbref.com/en/players/473803c9/Nikola-Krstovic"
2025,"Lecce","Serie A","Filip Marchwiński","POL","MF","23-137",2002,0.2,0,0,0,0,0,0,0,NA,0,0,0,0,0,0,0,0,"https://fbref.com/en/players/55a88fd9/Filip-Marchwinski"
2025,"Lecce","Serie A","Tete Morente","ESP","FW,MF","28-174",1996,22.5,27,17,10,11,6,10,36,27.8,26,16,1,15,14,41,31,1,"https://fbref.com/en/players/004d185e/Tete-Morente"
2025,"Lecce","Serie A","Konan N'dri","CIV","FW,MF","24-212",2000,3.4,3,3,0,0,3,2,3,66.7,1,4,0,4,1,4,0,0,"https://fbref.com/en/players/17329380/Konan-Ndri"
2025,"Lecce","Serie A","Remi Oudin","FRA","MF,FW","28-190",1996,3.3,3,1,1,1,1,2,4,50,2,6,2,4,2,5,1,0,"https://fbref.com/en/players/ea02beaf/Remi-Oudin"
2025,"Lecce","Serie A","Andy Pelmard","FRA","DF","25-076",2000,1.4,6,6,5,1,0,4,4,100,0,1,0,1,0,6,5,0,"https://fbref.com/en/players/f18d7ab2/Andy-Pelmard"
2025,"Lecce","Serie A","Santiago Pierotti","ARG","FW","24-054",2001,21.5,46,24,22,18,6,23,51,45.1,28,31,5,26,14,60,32,0,"https://fbref.com/en/players/ec315772/Santiago-Pierotti"
2025,"Lecce","Serie A","Balthazar Pierret","FRA","MF","25-012",2000,19.1,51,31,25,23,3,13,30,43.3,17,19,5,14,19,70,31,1,"https://fbref.com/en/players/c269463b/Balthazar-Pierret"
2025,"Lecce","Serie A","Hamza Rafia","TUN","MF","26-055",1999,11.8,44,27,14,25,5,15,32,46.9,17,7,2,5,4,48,18,1,"https://fbref.com/en/players/6b587d3d/Hamza-Rafia"
2025,"Lecce","Serie A","Ylber Ramadani","ALB","MF","29-045",1996,20.1,51,28,24,27,0,33,52,63.5,19,26,9,17,24,75,26,3,"https://fbref.com/en/players/ef3c876b/Ylber-Ramadani"
2025,"Lecce","Serie A","Ante Rebić","CRO","FW,MF","31-248",1993,8.8,12,9,5,5,2,3,9,33.3,6,7,1,6,2,14,4,1,"https://fbref.com/en/players/536cebe5/Ante-Rebic"
2025,"Lecce","Serie A","Marco Sala","ITA","DF","25-357",1999,0.8,1,0,0,1,0,0,1,0,1,1,0,1,0,1,0,0,"https://fbref.com/en/players/0c57be8b/Marco-Sala"
2025,"Lecce","Serie A","Nicola Sansone","ITA","MF,FW","33-259",1991,0.7,0,0,0,0,0,0,0,NA,0,0,0,0,0,0,0,0,"https://fbref.com/en/players/7eb97a8e/Nicola-Sansone"
2025,"Lecce","Serie A","Danilo Veiga","POR","DF","22-244",2002,4.2,8,6,4,4,0,6,13,46.2,7,5,0,5,4,12,14,0,"https://fbref.com/en/players/cc094532/Danilo-Veiga"
2025,"Leganés","La Liga","Adrià Altimira","ESP","DF,FW","24-060",2001,18.1,41,24,26,12,3,24,40,60,16,15,6,9,15,56,54,2,"https://fbref.com/en/players/757a3431/Adria-Altimira"
2025,"Leganés","La Liga","Aritz Arambarri","ESP","DF","27-116",1998,2,1,1,1,0,0,1,1,100,0,2,2,0,3,4,8,0,"https://fbref.com/en/players/f28876e5/Aritz-Arambarri"
2025,"Leganés","La Liga","Borna Barišić","CRO","DF","32-198",1992,0.1,0,0,0,0,0,0,0,NA,0,0,0,0,0,0,0,0,"https://fbref.com/en/players/712dd708/Borna-Barisic"
2025,"Leganés","La Liga","Darko Brašanac","SRB","MF","33-104",1992,18,26,11,5,15,6,9,17,52.9,8,24,11,13,16,42,34,0,"https://fbref.com/en/players/4accb7e0/Darko-Brasanac"
2025,"Leganés","La Liga","Julián Chicco","ARG","MF,DF","27-134",1998,3.4,11,7,3,6,2,5,8,62.5,3,2,0,2,4,15,10,0,"https://fbref.com/en/players/92dacb99/Julian-Chicco"
2025,"Leganés","La Liga","Seydouba Cissé","GUI","MF","24-106",2001,27.1,59,37,18,27,14,23,50,46,27,25,1,24,12,71,45,1,"https://fbref.com/en/players/0d13e455/Seydouba-Cisse"
2025,"Leganés","La Liga","Juan Cruz","ESP","FW,MF","25-032",2000,25.1,32,19,14,16,2,17,35,48.6,18,18,2,16,13,45,31,0,"https://fbref.com/en/players/cc2dd8a5/Juan-Cruz"
2025,"Leganés","La Liga","Diego","ESP","FW","25-039",2000,13.3,1,1,0,0,1,1,7,14.3,6,4,1,3,2,3,11,0,"https://fbref.com/en/players/b85a5126/Diego"
2025,"Leganés","La Liga","Yan Diomandé","CIV","MF,FW","18-194",2006,6.1,14,9,1,8,5,5,15,33.3,10,8,0,8,8,22,6,0,"https://fbref.com/en/players/919f5f54/Yan-Diomande"
2025,"Leganés","La Liga","Marko Dmitrović","SRB","GK","33-123",1992,32,1,1,1,0,0,1,2,50,1,0,0,0,0,1,27,3,"https://fbref.com/en/players/ac295d9e/Marko-Dmitrovic"
2025,"Leganés","La Liga","Duk","CPV","MF,FW","25-100",2000,2,8,4,3,3,2,3,5,60,2,4,0,4,1,9,2,0,"https://fbref.com/en/players/777c02e8/Duk"
2025,"Leganés","La Liga","Enric Franquesa","ESP","DF,FW","28-090",1997,6.8,17,9,9,6,2,9,13,69.2,4,7,1,6,5,22,12,0,"https://fbref.com/en/players/40883e3a/Enric-Franquesa"
2025,"Leganés","La Liga","Munir El Haddadi","MAR","FW,MF","29-268",1995,9.6,12,9,5,4,3,3,12,25,9,8,1,7,1,13,1,1,"https://fbref.com/en/players/8696bc90/Munir-El-Haddadi"
2025,"Leganés","La Liga","Sébastien Haller","CIV","FW","30-339",1994,4.5,2,0,1,0,1,1,2,50,1,1,0,1,0,2,7,0,"https://fbref.com/en/players/ba115a40/Sebastien-Haller"
2025,"Leganés","La Liga","Javi Hernández","ESP","DF","27-025",1998,26.5,26,15,16,7,3,17,46,37,29,25,5,20,23,49,98,0,"https://fbref.com/en/players/9a76c2e9/Javi-Hernandez"
2025,"Leganés","La Liga","Roberto López","ESP","MF","25-033",2000,4.4,8,6,4,4,0,5,15,33.3,10,5,0,5,1,9,7,2,"https://fbref.com/en/players/2a8c9f98/Roberto-Lopez"
2025,"Leganés","La Liga","Miguel","ESP","FW","25-266",1999,19.2,16,7,6,4,6,4,14,28.6,10,15,4,11,4,20,23,1,"https://fbref.com/en/players/6763373d/Miguel"
2025,"Leganés","La Liga","Matija Nastasić","SRB","DF","32-060",1993,23.4,25,11,21,4,0,17,25,68,8,39,30,9,21,46,165,0,"https://fbref.com/en/players/f35430a4/Matija-Nastasic"
2025,"Leganés","La Liga","Yvan Neyou","CMR","MF","28-144",1997,25.7,53,33,21,26,6,22,47,46.8,25,35,5,30,26,79,38,1,"https://fbref.com/en/players/0ad37003/Yvan-Neyou"
2025,"Leganés","La Liga","Dani Raba","ESP","FW,MF","29-210",1995,20.9,37,23,17,15,5,17,42,40.5,25,27,3,24,14,51,19,1,"https://fbref.com/en/players/ea6a7ab4/Dani-Raba"
2025,"Leganés","La Liga","Óscar Rodríguez Arnaiz","ESP","MF,FW","26-333",1998,14.8,32,17,10,16,6,14,32,43.8,18,10,1,9,20,52,20,0,"https://fbref.com/en/players/19709006/Oscar-Rodriguez-Arnaiz"
2025,"Leganés","La Liga","Valentin Rosier","FRA","DF","28-281",1996,28.8,72,52,48,16,8,43,68,63.2,25,40,15,25,52,124,149,2,"https://fbref.com/en/players/9b6d9b53/Valentin-Rosier"
2025,"Leganés","La Liga","Jorge Sáenz","ESP","DF","28-191",1996,18.8,37,23,18,18,1,11,20,55,9,26,17,9,25,62,161,0,"https://fbref.com/en/players/bfca375c/Jorge-Saenz"
2025,"Leganés","La Liga","Sergi","ESP","DF","33-037",1992,32.9,40,29,22,16,2,18,32,56.3,14,38,29,9,39,79,185,2,"https://fbref.com/en/players/65ac6ea0/Sergi"
2025,"Leganés","La Liga","Juan Soriano","ESP","GK","27-277",1997,6,1,1,1,0,0,1,1,100,0,0,0,0,0,1,2,0,"https://fbref.com/en/players/5512b1a9/Juan-Soriano"
2025,"Leganés","La Liga","Renato Tapia","PER","MF,DF","29-303",1995,26.9,61,35,30,27,4,24,50,48,26,58,23,35,27,88,86,2,"https://fbref.com/en/players/34269bdf/Renato-Tapia"
2025,"Leicester City","Premier League","Olabade Aluko","","DF","",NA,0,1,1,0,0,1,1,1,100,0,0,0,0,0,1,0,0,"https://fbref.com/en/players/12bb637a/Olabade-Aluko"
2025,"Leicester City","Premier League","Will Alves","ENG","FW","20-113",2005,0,0,0,0,0,0,0,0,NA,0,0,0,0,0,0,0,0,"https://fbref.com/en/players/39ef5a7b/Will-Alves"
2025,"Leicester City","Premier League","Jordan Ayew","GHA","FW,MF","33-258",1991,18.2,27,15,8,14,5,7,23,30.4,16,21,2,19,12,39,19,0,"https://fbref.com/en/players/da052c14/Jordan-Ayew"
2025,"Leicester City","Premier League","Victor Bernth Kristiansen","DEN","DF","22-162",2002,27.6,87,51,56,26,5,49,91,53.8,42,38,15,23,42,129,75,3,"https://fbref.com/en/players/505486d6/Victor-Bernth-Kristiansen"
2025,"Leicester City","Premier League","Facundo Buonanotte","ARG","FW,MF","20-155",2004,16.9,53,32,17,22,14,21,67,31.3,46,34,6,28,12,65,14,0,"https://fbref.com/en/players/468a7a91/Facundo-Buonanotte"
2025,"Leicester City","Premier League","Hamza Choudhury","BAN","MF,DF","27-238",1997,1.5,1,1,1,0,0,1,3,33.3,2,4,2,2,5,6,2,0,"https://fbref.com/en/players/7d2d3329/Hamza-Choudhury"
2025,"Leicester City","Premier League","Conor Coady","ENG","DF","32-091",1993,19,13,9,6,6,1,3,6,50,3,32,24,8,13,26,71,2,"https://fbref.com/en/players/2928dca2/Conor-Coady"
2025,"Leicester City","Premier League","Woyo Coulibaly","FRA","DF","26-007",1999,1.2,6,4,4,2,0,2,2,100,0,3,1,2,5,11,1,0,"https://fbref.com/en/players/beb6e3a6/Woyo-Coulibaly"
2025,"Leicester City","Premier League","Patson Daka","ZAM","FW,MF","26-230",1998,8.2,19,10,6,9,4,7,18,38.9,11,7,1,6,1,20,12,0,"https://fbref.com/en/players/ca45605e/Patson-Daka"
2025,"Leicester City","Premier League","Bobby De Cordova-Reid","JAM","FW","32-114",1993,8.3,9,4,3,6,0,4,14,28.6,10,6,1,5,0,9,10,0,"https://fbref.com/en/players/0f7533cd/Bobby-De-Cordova-Reid"
2025,"Leicester City","Premier League","Odsonne Édouard","FRA","FW","27-131",1998,0.3,1,1,1,0,0,0,0,NA,0,0,0,0,0,1,1,0,"https://fbref.com/en/players/0562b7f1/Odsonne-Edouard"
2025,"Leicester City","Premier League","Jake Evans","","FW","",NA,0.3,1,1,0,0,1,0,1,0,1,0,0,0,0,1,1,0,"https://fbref.com/en/players/cb7bcef0/Jake-Evans"
2025,"Leicester City","Premier League","Wout Faes","BEL","DF","27-054",1998,31.3,42,26,26,14,2,25,48,52.1,23,48,35,13,26,68,185,4,"https://fbref.com/en/players/9c221d14/Wout-Faes"
2025,"Leicester City","Premier League","Abdul Fatawu Issahaku","GHA","FW","21-080",2004,6.4,21,15,13,2,6,11,19,57.9,8,7,0,7,4,25,12,0,"https://fbref.com/en/players/bceda5ff/Abdul-Fatawu-Issahaku"
2025,"Leicester City","Premier League","Michael Golding","ENG","MF","19-004",2006,0,0,0,0,0,0,0,0,NA,0,0,0,0,0,0,0,0,"https://fbref.com/en/players/67c5e0e8/Michael-Golding"
2025,"Leicester City","Premier League","Mads Hermansen","DEN","GK","24-320",2000,26.5,1,1,1,0,0,1,1,100,0,1,0,1,0,1,13,4,"https://fbref.com/en/players/c924b17d/Mads-Hermansen"
2025,"Leicester City","Premier League","James Justin","ENG","DF","27-093",1998,32.4,58,37,29,23,6,32,55,58.2,23,48,17,31,46,104,141,3,"https://fbref.com/en/players/fb614c44/James-Justin"
2025,"Leicester City","Premier League","Bilal El Khannouss","MAR","MF,FW","21-017",2004,24.2,50,30,16,29,5,17,32,53.1,15,22,4,18,6,56,10,3,"https://fbref.com/en/players/f7042636/Bilal-El-Khannouss"
2025,"Leicester City","Premier League","Stephy Mavididi","ENG","FW","26-361",1998,17.9,34,19,16,10,8,14,42,33.3,28,26,2,24,11,45,15,0,"https://fbref.com/en/players/30144daa/Stephy-Mavididi"
2025,"Leicester City","Premier League","Kasey McAteer","IRL","FW","23-186",2001,9.5,23,16,11,9,3,14,29,48.3,15,18,2,16,5,28,15,0,"https://fbref.com/en/players/b2c66859/Kasey-McAteer"
2025,"Leicester City","Premier League","Jeremy Monga","","FW,MF","",NA,1.2,2,1,0,1,1,1,1,100,0,3,2,1,0,2,1,0,"https://fbref.com/en/players/4c168d3a/Jeremy-Monga"
2025,"Leicester City","Premier League","Wilfred Ndidi","NGA","MF","28-162",1996,25.8,85,51,45,32,8,30,61,49.2,31,47,19,28,31,116,80,0,"https://fbref.com/en/players/6b47c5db/Wilfred-Ndidi"
2025,"Leicester City","Premier League","Caleb Okoli","ITA","DF","23-318",2001,12.5,25,14,8,15,2,11,18,61.1,7,24,14,10,15,40,79,3,"https://fbref.com/en/players/8ec109e6/Caleb-Okoli"
2025,"Leicester City","Premier League","Ricardo Pereira","POR","DF","31-233",1993,4.3,13,8,4,6,3,7,14,50,7,8,3,5,4,17,11,0,"https://fbref.com/en/players/75a72a99/Ricardo-Pereira"
2025,"Leicester City","Premier League","Oliver Skipp","ENG","MF","24-253",2000,12.5,21,4,6,12,3,9,15,60,6,23,7,16,11,32,11,2,"https://fbref.com/en/players/6250083a/Oliver-Skipp"
2025,"Leicester City","Premier League","Boubakary Soumaré","FRA","MF","26-089",1999,24.1,37,20,24,12,1,21,33,63.6,12,22,10,12,27,64,34,4,"https://fbref.com/en/players/ae59b359/Boubakary-Soumare"
2025,"Leicester City","Premier League","Jakub Stolarczyk","POL","GK","24-159",2000,10,2,1,2,0,0,1,2,50,1,0,0,0,0,2,6,1,"https://fbref.com/en/players/a4a76b3d/Jakub-Stolarczyk"
2025,"Leicester City","Premier League","Luke Thomas","ENG","DF","23-351",2001,12.3,31,25,23,5,3,21,41,51.2,20,15,6,9,21,52,49,1,"https://fbref.com/en/players/fc027d02/Luke-Thomas"
2025,"Leicester City","Premier League","Jamie Vardy","ENG","FW","38-136",1987,31.4,19,13,7,7,5,4,13,30.8,9,8,4,4,5,24,24,0,"https://fbref.com/en/players/45963054/Jamie-Vardy"
2025,"Leicester City","Premier League","Jannik Vestergaard","DEN","DF","32-297",1992,15.5,22,10,16,6,0,9,15,60,6,21,14,7,16,38,74,1,"https://fbref.com/en/players/1900032e/Jannik-Vestergaard"
2025,"Leicester City","Premier League","Danny Ward","WAL","GK","31-339",1993,1.5,0,0,0,0,0,0,0,NA,0,0,0,0,0,0,1,0,"https://fbref.com/en/players/d3ce0e89/Danny-Ward"
2025,"Leicester City","Premier League","Harry Winks","ENG","MF","29-114",1996,17.1,24,11,12,10,2,13,30,43.3,17,19,7,12,9,33,20,0,"https://fbref.com/en/players/2f7acede/Harry-Winks"
2025,"Lens","Ligue 1","Jeremy Agbonifo","SWE","FW,MF","19-215",2005,3.3,7,6,6,0,1,3,7,42.9,4,2,1,1,1,8,0,1,"https://fbref.com/en/players/3d6aaa54/Jeremy-Agbonifo"
2025,"Lens","Ligue 1","Ruben Aguilar","FRA","DF,MF","32-031",1993,12.5,34,18,17,12,5,24,39,61.5,15,25,3,22,13,47,23,0,"https://fbref.com/en/players/3dd738a1/Ruben-Aguilar"
2025,"Lens","Ligue 1","Kyllian Antonio","FRA","DF,MF","17-143",2008,1.5,3,2,2,0,1,1,3,33.3,2,3,0,3,3,6,3,1,"https://fbref.com/en/players/ea36375c/Kyllian-Antonio"
2025,"Lens","Ligue 1","Neil El Aynaoui","FRA","MF","23-329",2001,17.6,39,21,18,15,6,12,34,35.3,22,34,8,26,30,69,29,0,"https://fbref.com/en/players/17e1261b/Neil-El-Aynaoui"
2025,"Lens","Ligue 1","Juma Bah","SLE","DF","19-046",2006,7.6,16,10,6,10,0,5,7,71.4,2,10,7,3,17,33,47,1,"https://fbref.com/en/players/7b505397/Juma-Bah"
2025,"Lens","Ligue 1","Gabin Capuano","FRA","FW","19-031",2006,0.1,0,0,0,0,0,0,0,NA,0,0,0,0,0,0,0,0,"https://fbref.com/en/players/9cbf42e7/Gabin-Capuano"
2025,"Lens","Ligue 1","Jhoanner Chávez","ECU","DF,MF","23-032",2002,6.6,9,5,4,4,1,2,7,28.6,5,10,1,9,6,15,13,0,"https://fbref.com/en/players/649b57e9/Jhoanner-Chavez"
2025,"Lens","Ligue 1","David Costa","POR","MF,FW","24-142",2001,3.9,2,0,1,1,0,1,4,25,3,5,1,4,1,3,0,0,"https://fbref.com/en/players/59948ef7/David-Costa"
2025,"Lens","Ligue 1","Kevin Danso","AUT","DF","26-250",1998,12,19,7,12,5,2,12,16,75,4,25,19,6,20,39,62,1,"https://fbref.com/en/players/6e33125f/Kevin-Danso"
2025,"Lens","Ligue 1","Kembo Diliwidi","FRA","DF","19-113",2006,0,0,0,0,0,0,0,0,NA,0,0,0,0,0,0,0,0,"https://fbref.com/en/players/bd604262/Kembo-Diliwidi"
2025,"Lens","Ligue 1","Andy Diouf","FRA","MF","22-010",2003,24.7,37,26,10,22,5,16,40,40,24,24,1,23,15,52,18,2,"https://fbref.com/en/players/9b5237b1/Andy-Diouf"
2025,"Lens","Ligue 1","Rayan Fofana","FRA","FW,MF","19-104",2006,0.3,2,2,1,1,0,0,0,NA,0,0,0,0,0,2,0,0,"https://fbref.com/en/players/ad48a336/Rayan-Fofana"
2025,"Lens","Ligue 1","Przemysław Frankowski","POL","DF","30-045",1995,15.4,32,21,17,10,5,19,30,63.3,11,10,2,8,19,51,28,0,"https://fbref.com/en/players/00a8d210/Przemyslaw-Frankowski"
2025,"Lens","Ligue 1","Angelo Fulgini","FRA","MF,FW","28-280",1996,11.6,14,10,6,4,4,6,16,37.5,10,11,1,10,2,16,3,0,"https://fbref.com/en/players/4b96c347/Angelo-Fulgini"
2025,"Lens","Ligue 1","Jonathan Gradit","FRA","DF","32-184",1992,23.5,44,23,22,19,3,23,40,57.5,17,27,12,15,25,69,122,2,"https://fbref.com/en/players/06c48679/Jonathan-Gradit"
2025,"Lens","Ligue 1","Abdukodir Khusanov","UZB","DF","21-087",2004,10.8,15,11,9,5,1,7,11,63.6,4,17,11,6,26,41,57,0,"https://fbref.com/en/players/d17ce930/Abdukodir-Khusanov"
2025,"Lens","Ligue 1","Hervé Koffi","BFA","GK","28-223",1996,5,1,1,1,0,0,1,1,100,0,0,0,0,0,1,5,0,"https://fbref.com/en/players/faf873a7/Herve-Koffi"
2025,"Lens","Ligue 1","Goduine Koyalipou","CTA","FW","25-101",2000,9.8,3,2,0,3,0,1,1,100,0,4,0,4,1,4,8,0,"https://fbref.com/en/players/2659a508/Goduine-Koyalipou"
2025,"Lens","Ligue 1","Rémy Labeau Lascary","GLP","FW,MF","22-085",2003,7.1,16,10,7,6,3,5,11,45.5,6,5,0,5,1,17,7,0,"https://fbref.com/en/players/c90f380c/Remy-Labeau-Lascary"
2025,"Lens","Ligue 1","Deiver Machado","COL","DF,MF","31-267",1993,20.1,36,26,14,14,8,17,30,56.7,13,20,4,16,16,52,34,2,"https://fbref.com/en/players/b3f8bdef/Deiver-Machado"
2025,"Lens","Ligue 1","Facundo Medina","ARG","DF","25-364",1999,28.3,44,29,22,18,4,24,42,57.1,18,30,10,20,32,76,70,0,"https://fbref.com/en/players/6f5ec8bb/Facundo-Medina"
2025,"Lens","Ligue 1","Nampalys Mendy","SEN","MF","32-338",1992,6.5,15,8,4,7,4,6,14,42.9,8,8,2,6,9,24,8,0,"https://fbref.com/en/players/1598599e/Nampalys-Mendy"
2025,"Lens","Ligue 1","M'Bala Nzola","ANG","FW","28-282",1996,16.2,5,4,0,1,4,3,9,33.3,6,9,1,8,5,10,7,0,"https://fbref.com/en/players/a4948e67/MBala-Nzola"
2025,"Lens","Ligue 1","Hamzat Ojediran","NGA","MF,FW","21-194",2003,4.6,28,15,12,13,3,7,19,36.8,12,10,2,8,10,38,7,0,"https://fbref.com/en/players/25124a21/Hamzat-Ojediran"
2025,"Lens","Ligue 1","Tom Pouilly","FRA","DF,MF","21-343",2003,3,9,6,5,1,3,5,10,50,5,5,1,4,4,13,11,0,"https://fbref.com/en/players/dafce747/Tom-Pouilly"
2025,"Lens","Ligue 1","Mathew Ryan","AUS","GK","33-049",1992,14,1,0,1,0,0,1,2,50,1,0,0,0,1,2,2,2,"https://fbref.com/en/players/4535e4bb/Mathew-Ryan"
2025,"Lens","Ligue 1","Wesley Saïd","FRA","FW","30-038",1995,10.1,16,11,3,10,3,6,13,46.2,7,6,0,6,2,18,2,0,"https://fbref.com/en/players/90fcf472/Wesley-Said"
2025,"Lens","Ligue 1","Brice Samba","FRA","GK","31-032",1994,15,0,0,0,0,0,0,0,NA,0,0,0,0,1,1,6,2,"https://fbref.com/en/players/60d90c55/Brice-Samba"
2025,"Lens","Ligue 1","Malang Sarr","FRA","DF","26-124",1999,15.4,21,13,12,6,3,16,27,59.3,11,18,9,9,22,43,63,3,"https://fbref.com/en/players/4315f30d/Malang-Sarr"
2025,"Lens","Ligue 1","Martin Satriano","URU","FW,DF","24-096",2001,1,3,1,1,1,1,3,3,100,0,0,0,0,0,3,2,0,"https://fbref.com/en/players/86383d0e/Martin-Satriano"
2025,"Lens","Ligue 1","Florian Sotoca","FRA","FW,MF","34-214",1990,19.9,22,13,3,8,11,12,22,54.5,10,12,2,10,14,36,25,0,"https://fbref.com/en/players/7a42d0df/Florian-Sotoca"
2025,"Lens","Ligue 1","Adrien Thomasson","FRA","MF","31-168",1993,29.1,90,47,42,25,23,52,95,54.7,43,48,3,45,19,109,28,2,"https://fbref.com/en/players/c76b7567/Adrien-Thomasson"
2025,"Lens","Ligue 1","Anass Zaroury","MAR","FW,MF","24-201",2000,15.6,23,17,6,12,5,9,26,34.6,17,9,0,9,6,29,15,0,"https://fbref.com/en/players/07d65234/Anass-Zaroury"
2025,"Leverkusen","Bundesliga","Amine Adli","MAR","MF,FW","25-017",2000,8.5,15,9,4,2,9,4,11,36.4,7,11,0,11,0,15,4,0,"https://fbref.com/en/players/dcfb17f4/Amine-Adli"
2025,"Leverkusen","Bundesliga","Robert Andrich","GER","MF,DF","30-247",1994,17.8,24,12,8,14,2,7,14,50,7,16,8,8,29,53,23,0,"https://fbref.com/en/players/e0b113a7/Robert-Andrich"
2025,"Leverkusen","Bundesliga","Arthur","BRA","DF","22-071",2003,8.4,14,11,3,9,2,5,10,50,5,8,0,8,9,23,29,0,"https://fbref.com/en/players/8a958856/Arthur"
2025,"Leverkusen","Bundesliga","Jeanuël Belocian","FRA","DF,MF","20-099",2005,0.8,1,1,1,0,0,1,1,100,0,0,0,0,0,1,2,0,"https://fbref.com/en/players/c678ddd7/Jeanuel-Belocian"
2025,"Leverkusen","Bundesliga","Victor Boniface","NGA","FW","24-155",2000,11.2,5,4,0,3,2,3,4,75,1,1,0,1,0,5,5,0,"https://fbref.com/en/players/b146275b/Victor-Boniface"
2025,"Leverkusen","Bundesliga","Emi Buendía","ARG","MF","28-153",1996,2.9,6,5,1,4,1,5,8,62.5,3,6,0,6,0,6,0,0,"https://fbref.com/en/players/66b76d44/Emi-Buendia"
2025,"Leverkusen","Bundesliga","Jeremie Frimpong","NED","DF,MF","24-168",2000,25.7,33,25,14,12,7,16,29,55.2,13,25,0,25,8,41,22,1,"https://fbref.com/en/players/74f2e748/Jeremie-Frimpong"
2025,"Leverkusen","Bundesliga","Aleix García","ESP","MF","27-333",1997,16.2,13,7,4,6,3,7,15,46.7,8,12,2,10,11,24,24,1,"https://fbref.com/en/players/a10361d2/Aleix-Garcia"
2025,"Leverkusen","Bundesliga","Álex Grimaldo","ESP","DF","29-249",1995,29.3,24,14,13,7,4,16,42,38.1,26,22,3,19,16,40,43,3,"https://fbref.com/en/players/b1f4086c/Alex-Grimaldo"
2025,"Leverkusen","Bundesliga","Mario Hermoso","ESP","DF","29-343",1995,3.3,0,0,0,0,0,0,0,NA,0,3,1,2,9,9,15,1,"https://fbref.com/en/players/555f3a0b/Mario-Hermoso"
2025,"Leverkusen","Bundesliga","Piero Hincapié","ECU","DF","23-138",2002,29.7,52,40,27,15,10,25,41,61,16,40,20,20,32,84,114,1,"https://fbref.com/en/players/0c7a48f8/Piero-Hincapie"
2025,"Leverkusen","Bundesliga","Jonas Hofmann","GER","MF,DF","32-317",1992,4,2,0,0,2,0,1,4,25,3,2,0,2,0,2,3,0,"https://fbref.com/en/players/2903a856/Jonas-Hofmann"
2025,"Leverkusen","Bundesliga","Lukáš Hrádecký","FIN","GK","35-184",1989,29,0,0,0,0,0,0,1,0,1,0,0,0,0,0,8,2,"https://fbref.com/en/players/ad3389d5/Lukas-Hradecky"
2025,"Leverkusen","Bundesliga","Matej Kovar","CZE","GK","25-010",2000,5,0,0,0,0,0,0,0,NA,0,0,0,0,0,0,0,1,"https://fbref.com/en/players/bc67a0e1/Matej-Kovar"
2025,"Leverkusen","Bundesliga","Nordi Mukiele","FRA","DF","27-207",1997,10,20,16,8,8,4,12,18,66.7,6,10,0,10,16,36,37,2,"https://fbref.com/en/players/ac73ec79/Nordi-Mukiele"
2025,"Leverkusen","Bundesliga","Exequiel Palacios","ARG","MF","26-234",1998,12.8,22,15,8,10,4,10,18,55.6,8,14,1,13,13,35,15,1,"https://fbref.com/en/players/e82adcab/Exequiel-Palacios"
2025,"Leverkusen","Bundesliga","Patrik Schick","CZE","FW","29-123",1996,18.7,6,5,1,3,2,1,5,20,4,9,1,8,4,10,17,1,"https://fbref.com/en/players/5d4f7d61/Patrik-Schick"
2025,"Leverkusen","Bundesliga","Jonathan Tah","GER","DF","29-105",1996,33,19,12,12,6,1,10,16,62.5,6,22,16,6,36,55,157,2,"https://fbref.com/en/players/bd142efb/Jonathan-Tah"
2025,"Leverkusen","Bundesliga","Edmond Tapsoba","BFA","DF","26-114",1999,27.9,39,24,19,16,4,22,39,56.4,17,21,14,7,24,63,89,3,"https://fbref.com/en/players/a73c8f95/Edmond-Tapsoba"
2025,"Leverkusen","Bundesliga","Nathan Tella","NGA","MF,FW","25-326",1999,15.1,16,11,4,7,5,5,13,38.5,8,15,1,14,4,20,10,0,"https://fbref.com/en/players/f1e94cd6/Nathan-Tella"
2025,"Leverkusen","Bundesliga","Martin Terrier","FRA","MF,FW","28-084",1997,6.5,4,2,1,0,3,1,4,25,3,3,0,3,1,5,1,0,"https://fbref.com/en/players/5148dcc5/Martin-Terrier"
2025,"Leverkusen","Bundesliga","Florian Wirtz","GER","MF,FW","22-024",2003,26.1,32,20,10,12,10,9,22,40.9,13,32,3,29,10,42,6,1,"https://fbref.com/en/players/e7fcf289/Florian-Wirtz"
2025,"Leverkusen","Bundesliga","Granit Xhaka","SUI","MF","32-242",1992,32.1,48,26,15,27,6,24,42,57.1,18,30,7,23,12,60,52,6,"https://fbref.com/en/players/e61b8aee/Granit-Xhaka"
2025,"Lille","Ligue 1","Chuba Akpom","ENG","FW","29-230",1995,7.1,8,5,0,4,4,2,6,33.3,4,9,0,9,0,8,3,0,"https://fbref.com/en/players/e2b384d2/Chuba-Akpom"
2025,"Lille","Ligue 1","Benjamin André","FRA","MF","34-297",1990,29.9,103,57,31,60,12,54,96,56.3,42,42,6,36,48,151,56,0,"https://fbref.com/en/players/ef9c1c95/Benjamin-Andre"
2025,"Lille","Ligue 1","Hákon Arnar Haraldsson","ISL","MF,FW","22-047",2003,19.5,36,16,9,17,10,16,33,48.5,17,10,2,8,8,44,6,0,"https://fbref.com/en/players/e2ae54db/Hakon-Arnar-Haraldsson"
2025,"Lille","Ligue 1","Mitchel Bakker","NED","FW,DF","24-341",2000,12.7,23,13,6,11,6,10,19,52.6,9,10,1,9,12,35,15,0,"https://fbref.com/en/players/a8567629/Mitchel-Bakker"
2025,"Lille","Ligue 1","Nabil Bentaleb","ALG","MF","30-184",1994,3.7,4,3,2,0,2,3,7,42.9,4,5,0,5,5,9,7,2,"https://fbref.com/en/players/3189f61a/Nabil-Bentaleb"
2025,"Lille","Ligue 1","Ayyoub Bouaddi","FRA","MF","17-237",2007,12.8,50,31,21,21,8,19,32,59.4,13,12,3,9,10,60,12,1,"https://fbref.com/en/players/8006228f/Ayyoub-Bouaddi"
2025,"Lille","Ligue 1","Rémy Cabella","FRA","FW,MF","35-080",1990,11.2,39,19,16,13,10,19,33,57.6,14,10,1,9,8,47,5,0,"https://fbref.com/en/players/148e136f/Remy-Cabella"
2025,"Lille","Ligue 1","Lucas Chevalier","FRA","GK","23-202",2001,34,3,2,3,0,0,3,4,75,1,0,0,0,0,3,13,4,"https://fbref.com/en/players/b3d76d84/Lucas-Chevalier"
2025,"Lille","Ligue 1","Jonathan David","CAN","FW","25-133",2000,28.4,24,8,3,12,9,9,21,42.9,12,13,2,11,7,31,10,1,"https://fbref.com/en/players/ce50fd99/Jonathan-David"
2025,"Lille","Ligue 1","Bafodé Diakité","FRA","DF","24-141",2001,30.7,31,18,17,11,3,18,26,69.2,8,30,17,13,27,58,99,5,"https://fbref.com/en/players/1bfb6fef/Bafode-Diakite"
2025,"Lille","Ligue 1","Matias Fernandez-Pardo","BEL","FW,MF","20-113",2005,11.8,12,9,3,6,3,6,12,50,6,9,0,9,3,15,6,0,"https://fbref.com/en/players/0cdb6a2a/Matias-Fernandez-Pardo"
2025,"Lille","Ligue 1","André Gomes","POR","MF","31-301",1993,14.2,27,13,9,11,7,11,31,35.5,20,7,1,6,6,33,11,2,"https://fbref.com/en/players/1961b2aa/Andre-Gomes"
2025,"Lille","Ligue 1","Angel Gomes","ENG","MF","24-269",2000,8.2,10,6,4,4,2,2,12,16.7,10,0,0,0,0,10,2,0,"https://fbref.com/en/players/645a3363/Angel-Gomes"
2025,"Lille","Ligue 1","Gabriel Gudmundsson","SWE","DF","26-028",1999,19.8,36,25,15,15,6,23,36,63.9,13,19,7,12,17,53,41,3,"https://fbref.com/en/players/d5d22a58/Gabriel-Gudmundsson"
2025,"Lille","Ligue 1","Ismaily","BRA","DF","35-136",1990,10,33,17,17,12,4,17,26,65.4,9,15,1,14,13,46,49,0,"https://fbref.com/en/players/cf182add/Ismaily"
2025,"Lille","Ligue 1","Younes Lachaab","FRA","MF,FW","20-141",2005,0.1,1,1,0,0,1,1,1,100,0,0,0,0,1,2,0,0,"https://fbref.com/en/players/fdfe71e8/Younes-Lachaab"
2025,"Lille","Ligue 1","Mohamed Lamine Bayo","GUI","FW","26-357",1998,3.4,1,1,0,0,1,1,1,100,0,0,0,0,0,1,4,0,"https://fbref.com/en/players/01870104/Mohamed-Lamine-Bayo"
2025,"Lille","Ligue 1","Aaron Malouda","FRA","FW","19-178",2005,0,0,0,0,0,0,0,0,NA,0,0,0,0,0,0,0,0,"https://fbref.com/en/players/4fe2648c/Aaron-Malouda"
2025,"Lille","Ligue 1","Aïssa Mandi","ALG","DF","33-217",1991,19.3,31,17,12,15,4,16,22,72.7,6,23,11,12,15,46,54,0,"https://fbref.com/en/players/fbd6378b/Aissa-Mandi"
2025,"Lille","Ligue 1","Ethan Mbappé","FRA","MF,FW","18-149",2006,2.5,6,2,3,2,1,0,4,0,4,6,0,6,1,7,0,0,"https://fbref.com/en/players/d595de71/Ethan-Mbappe"
2025,"Lille","Ligue 1","Thomas Meunier","BEL","DF","33-257",1991,21.4,53,38,32,15,6,33,49,67.3,16,21,8,13,34,87,64,0,"https://fbref.com/en/players/e162b013/Thomas-Meunier"
2025,"Lille","Ligue 1","Ngal'Ayel Mukau","COD","MF","20-178",2004,13.2,33,18,9,22,2,17,29,58.6,12,14,0,14,15,48,22,0,"https://fbref.com/en/players/bb461b8a/NgalAyel-Mukau"
2025,"Lille","Ligue 1","Alexsandro Ribeiro","BRA","DF","25-291",1999,30,32,19,18,13,1,20,30,66.7,10,23,13,10,27,59,143,3,"https://fbref.com/en/players/102c9665/Alexsandro-Ribeiro"
2025,"Lille","Ligue 1","Osame Sahraoui","MAR","FW,MF","23-350",2001,14.4,13,9,4,4,5,3,8,37.5,5,14,1,13,7,20,8,1,"https://fbref.com/en/players/6f9fa232/Osame-Sahraoui"
2025,"Lille","Ligue 1","Tiago Santos","POR","DF","22-308",2002,4.5,12,7,4,5,3,6,9,66.7,3,2,0,2,2,14,4,0,"https://fbref.com/en/players/3eeebc87/Tiago-Santos"
2025,"Lille","Ligue 1","Ousmane Toure","FRA","DF","20-098",2005,0.1,0,0,0,0,0,0,0,NA,0,0,0,0,1,1,2,0,"https://fbref.com/en/players/2a0f917e/Ousmane-Toure"
2025,"Lille","Ligue 1","Edon Zhegrova","KVX","FW,MF","26-057",1999,10.9,5,2,3,0,2,2,7,28.6,5,8,0,8,4,9,1,0,"https://fbref.com/en/players/34a88e3e/Edon-Zhegrova"
2025,"Liverpool","Premier League","Trent Alexander-Arnold","ENG","DF","26-232",1998,26.3,72,50,44,19,9,49,105,46.7,56,26,9,17,31,103,55,4,"https://fbref.com/en/players/cd1acf9d/Trent-Alexander-Arnold"
2025,"Liverpool","Premier League","Alisson","BRA","GK","32-237",1992,27.9,1,0,1,0,0,0,1,0,1,0,0,0,0,1,13,1,"https://fbref.com/en/players/7a2e46a8/Alisson"
2025,"Liverpool","Premier League","Conor Bradley","NIR","DF","21-322",2003,8.4,14,10,7,5,2,11,22,50,11,9,2,7,4,18,31,0,"https://fbref.com/en/players/bbd67769/Conor-Bradley"
2025,"Liverpool","Premier League","Federico Chiesa","ITA","FW","27-214",1997,1.2,1,0,0,1,0,0,2,0,2,1,0,1,0,1,1,1,"https://fbref.com/en/players/b0f7e36c/Federico-Chiesa"
2025,"Liverpool","Premier League","Jayden Danns","ENG","MF","19-131",2006,0.1,0,0,0,0,0,0,1,0,1,0,0,0,0,0,0,0,"https://fbref.com/en/players/003cf4d1/Jayden-Danns"
2025,"Liverpool","Premier League","Luis Díaz","COL","FW","28-134",1997,26.7,39,26,13,20,6,15,39,38.5,24,19,0,19,7,46,7,1,"https://fbref.com/en/players/4a1a9578/Luis-Diaz"
2025,"Liverpool","Premier League","Harvey Elliott","ENG","MF","22-053",2003,4.1,5,3,3,1,1,2,8,25,6,7,2,5,1,6,3,1,"https://fbref.com/en/players/b9e1436c/Harvey-Elliott"
2025,"Liverpool","Premier League","Wataru Endo","JPN","MF,DF","32-107",1993,3,12,8,7,5,0,6,10,60,4,8,1,7,6,18,9,0,"https://fbref.com/en/players/c149016b/Wataru-Endo"
2025,"Liverpool","Premier League","Cody Gakpo","NED","FW","26-020",1999,21.5,28,16,6,13,9,13,25,52,12,23,3,20,12,40,19,1,"https://fbref.com/en/players/1971591f/Cody-Gakpo"
2025,"Liverpool","Premier League","Joe Gomez","ENG","DF","28-004",1997,5.8,13,10,5,7,1,11,16,68.8,5,9,6,3,7,20,20,2,"https://fbref.com/en/players/7a11550b/Joe-Gomez"
2025,"Liverpool","Premier League","Ryan Gravenberch","NED","MF","23-011",2002,35.1,69,35,27,29,13,32,56,57.1,24,35,10,25,60,129,59,2,"https://fbref.com/en/players/b8e740fb/Ryan-Gravenberch"
2025,"Liverpool","Premier League","Vitezslav Jaros","CZE","GK","23-308",2001,0.1,0,0,0,0,0,0,0,NA,0,0,0,0,0,0,0,0,"https://fbref.com/en/players/12bb4d6a/Vitezslav-Jaros"
2025,"Liverpool","Premier League","Curtis Jones","ENG","MF,DF","24-117",2001,19,39,22,6,23,10,17,27,63,10,22,9,13,7,46,10,3,"https://fbref.com/en/players/4fb9c88f/Curtis-Jones"
2025,"Liverpool","Premier League","Diogo Jota","POR","FW","28-174",1996,13.3,14,8,2,8,4,7,19,36.8,12,9,0,9,8,22,6,0,"https://fbref.com/en/players/178ae8f8/Diogo-Jota"
2025,"Liverpool","Premier League","Caoimhín Kelleher","IRL","GK","26-185",1998,10,0,0,0,0,0,0,0,NA,0,0,0,0,0,0,1,2,"https://fbref.com/en/players/62d7ef38/Caoimhin-Kelleher"
2025,"Liverpool","Premier League","Ibrahima Konaté","FRA","DF","26-002",1999,28.5,40,26,25,13,2,25,35,71.4,10,29,15,14,17,57,133,3,"https://fbref.com/en/players/5ed9b537/Ibrahima-Konate"
2025,"Liverpool","Premier League","Alexis Mac Allister","ARG","MF","26-154",1998,28.9,95,58,28,51,16,55,104,52.9,49,61,6,55,22,117,29,1,"https://fbref.com/en/players/83d074ff/Alexis-Mac-Allister"
2025,"Liverpool","Premier League","Darwin Núñez","URU","FW","25-337",1999,12.6,21,18,11,4,6,7,18,38.9,11,6,0,6,4,25,12,0,"https://fbref.com/en/players/4d77b365/Darwin-Nunez"
2025,"Liverpool","Premier League","Jarell Quansah","ENG","DF","22-118",2003,5.5,12,8,8,4,0,7,10,70,3,10,7,3,7,19,28,1,"https://fbref.com/en/players/4125cb98/Jarell-Quansah"
2025,"Liverpool","Premier League","Andrew Robertson","SCO","DF","31-077",1994,27.6,39,22,25,10,4,31,51,60.8,20,10,4,6,21,60,54,2,"https://fbref.com/en/players/2e4f5f03/Andrew-Robertson"
2025,"Liverpool","Premier League","Mohamed Salah","EGY","FW","32-346",1992,37.5,21,11,7,5,9,8,17,47.1,9,12,0,12,9,30,5,0,"https://fbref.com/en/players/e342ad68/Mohamed-Salah"
2025,"Liverpool","Premier League","Dominik Szoboszlai","HUN","MF","24-214",2000,27.7,38,20,14,19,5,17,45,37.8,28,39,5,34,9,47,19,2,"https://fbref.com/en/players/934e1968/Dominik-Szoboszlai"
2025,"Liverpool","Premier League","Kostas Tsimikas","GRE","DF","29-015",1996,9.3,31,20,15,11,5,14,23,60.9,9,5,2,3,11,42,20,0,"https://fbref.com/en/players/f315ca93/Kostas-Tsimikas"
2025,"Liverpool","Premier League","Virgil van Dijk","NED","DF","33-323",1991,37,38,20,17,19,2,13,22,59.1,9,27,16,11,56,94,190,4,"https://fbref.com/en/players/e06683ca/Virgil-van-Dijk"
2025,"Lyon","Ligue 1","Abner","BRA","DF","25-000",2000,12.1,29,20,12,10,7,21,32,65.6,11,15,2,13,5,34,41,0,"https://fbref.com/en/players/7f9c5d2d/Abner"
2025,"Lyon","Ligue 1","Adryelson","BRA","DF","27-065",1998,0,0,0,0,0,0,0,0,NA,0,0,0,0,1,1,1,0,"https://fbref.com/en/players/e980e78d/Adryelson"
2025,"Lyon","Ligue 1","Paul Akouokou","CIV","MF","27-158",1997,0.2,1,0,0,1,0,0,0,NA,0,0,0,0,1,2,0,1,"https://fbref.com/en/players/31f5b89b/Paul-Akouokou"
2025,"Lyon","Ligue 1","Thiago Almada","ARG","MF,FW","24-031",2001,10.6,14,8,7,5,2,7,21,33.3,14,2,0,2,7,21,6,3,"https://fbref.com/en/players/27f33438/Thiago-Almada"
2025,"Lyon","Ligue 1","Téo Barisic","FRA","DF","20-239",2004,0,0,0,0,0,0,0,0,NA,0,0,0,0,0,0,1,0,"https://fbref.com/en/players/70530825/Teo-Barisic"
2025,"Lyon","Ligue 1","Saïd Benrahma","ALG","FW,MF","29-290",1995,8.2,9,5,4,4,1,3,10,30,7,6,0,6,3,12,2,0,"https://fbref.com/en/players/5a04fd92/Said-Benrahma"
2025,"Lyon","Ligue 1","Duje Ćaleta-Car","CRO","DF","28-252",1996,17.6,20,12,11,9,0,10,19,52.6,9,33,25,8,17,37,97,2,"https://fbref.com/en/players/94f8d10c/Duje-Caleta-Car"
2025,"Lyon","Ligue 1","Maxence Caqueret","FRA","MF","25-101",2000,6.4,21,11,5,11,5,4,22,18.2,18,12,2,10,7,28,2,0,"https://fbref.com/en/players/f81ef10d/Maxence-Caqueret"
2025,"Lyon","Ligue 1","Rayan Cherki","FRA","FW,MF","21-283",2003,22.7,15,12,3,8,4,6,28,21.4,22,6,0,6,7,22,6,0,"https://fbref.com/en/players/b34c63a5/Rayan-Cherki"
2025,"Lyon","Ligue 1","Rémy Descamps","FRA","GK","28-336",1996,1,0,0,0,0,0,0,0,NA,0,0,0,0,0,0,0,0,"https://fbref.com/en/players/477e50ce/Remy-Descamps"
2025,"Lyon","Ligue 1","Mahamadou Diawara","FRA","MF","20-099",2005,0.2,1,0,0,1,0,1,3,33.3,2,2,0,2,0,1,0,0,"https://fbref.com/en/players/1906b842/Mahamadou-Diawara"
2025,"Lyon","Ligue 1","Malick Fofana","BEL","FW","20-057",2005,17.7,22,11,8,11,3,8,17,47.1,9,12,0,12,8,30,6,0,"https://fbref.com/en/players/8236f673/Malick-Fofana"
2025,"Lyon","Ligue 1","Sael Kumbedi","FRA","DF","20-062",2005,10.6,28,14,11,13,4,14,20,70,6,11,3,8,8,36,32,1,"https://fbref.com/en/players/c385bf49/Sael-Kumbedi"
2025,"Lyon","Ligue 1","Alexandre Lacazette","FRA","FW","33-364",1991,22.8,13,6,3,7,3,5,16,31.3,11,13,3,10,8,21,7,0,"https://fbref.com/en/players/9dbb75ca/Alexandre-Lacazette"
2025,"Lyon","Ligue 1","Ainsley Maitland-Niles","ENG","DF","27-271",1997,22.1,71,44,30,26,15,48,76,63.2,28,28,4,24,25,96,61,6,"https://fbref.com/en/players/e3a5814e/Ainsley-Maitland-Niles"
2025,"Lyon","Ligue 1","Orel Mangala","BEL","MF","27-070",1998,0.7,1,0,0,0,1,0,1,0,1,2,0,2,0,1,1,0,"https://fbref.com/en/players/a572e291/Orel-Mangala"
2025,"Lyon","Ligue 1","Clinton Mata","ANG","DF","32-201",1992,26.3,41,29,23,14,4,28,36,77.8,8,26,17,9,46,87,72,3,"https://fbref.com/en/players/55abe554/Clinton-Mata"
2025,"Lyon","Ligue 1","Nemanja Matić","SRB","MF","36-299",1988,22.3,42,29,15,21,6,23,41,56.1,18,21,9,12,18,60,31,1,"https://fbref.com/en/players/eb7822d7/Nemanja-Matic"
2025,"Lyon","Ligue 1","Georges Mikautadze","GEO","FW","24-208",2000,16.1,7,6,1,3,3,3,9,33.3,6,11,0,11,4,11,6,0,"https://fbref.com/en/players/4788cb6b/Georges-Mikautadze"
2025,"Lyon","Ligue 1","Moussa Niakhate","SEN","DF","29-080",1996,30.3,47,27,37,8,2,24,32,75,8,26,17,9,25,72,143,3,"https://fbref.com/en/players/00242715/Moussa-Niakhate"
2025,"Lyon","Ligue 1","Ernest Nuamah","GHA","FW,MF","21-207",2003,11.7,21,11,15,4,2,12,27,44.4,15,9,1,8,8,29,8,1,"https://fbref.com/en/players/234a703c/Ernest-Nuamah"
2025,"Lyon","Ligue 1","Warmed Omari","COM","DF","25-034",2000,0.1,0,0,0,0,0,0,0,NA,0,0,0,0,0,0,1,0,"https://fbref.com/en/players/4534a352/Warmed-Omari"
2025,"Lyon","Ligue 1","Gift Orban","NGA","FW,DF","22-314",2002,2.1,0,0,0,0,0,0,1,0,1,0,0,0,0,0,0,0,"https://fbref.com/en/players/de17db90/Gift-Orban"
2025,"Lyon","Ligue 1","Lucas Perri","BRA","GK","27-168",1997,33,1,1,1,0,0,0,4,0,4,1,0,1,0,1,22,1,"https://fbref.com/en/players/5dbd461a/Lucas-Perri"
2025,"Lyon","Ligue 1","Alejandro Rodriguez","POR","MF","17-078",2008,0.2,0,0,0,0,0,0,0,NA,0,0,0,0,0,0,0,0,"https://fbref.com/en/players/fbe1cf6b/Alejandro-Rodriguez"
2025,"Lyon","Ligue 1","Mama Samba Baldé","GNB","FW","29-202",1995,0.4,2,2,0,2,0,0,0,NA,0,0,0,0,1,3,1,0,"https://fbref.com/en/players/fb14aa28/Mama-Samba-Balde"
2025,"Lyon","Ligue 1","Nicolás Tagliafico","ARG","DF","32-269",1992,21.1,57,37,24,22,11,29,48,60.4,19,25,7,18,36,93,55,0,"https://fbref.com/en/players/f0661424/Nicolas-Tagliafico"
2025,"Lyon","Ligue 1","Tanner Tessmann","USA","MF","23-245",2001,13.7,25,15,11,10,4,12,25,48,13,13,7,6,19,44,29,1,"https://fbref.com/en/players/ac277993/Tanner-Tessmann"
2025,"Lyon","Ligue 1","Corentin Tolisso","FRA","MF","30-297",1994,25.9,57,25,21,26,10,34,65,52.3,31,52,13,39,22,79,41,1,"https://fbref.com/en/players/652d4c37/Corentin-Tolisso"
2025,"Lyon","Ligue 1","Jordan Veretout","FRA","MF","32-087",1993,17.3,30,14,14,14,2,17,40,42.5,23,17,3,14,5,35,23,1,"https://fbref.com/en/players/4a56052c/Jordan-Veretout"
2025,"Lyon","Ligue 1","Wilfried Zaha","CIV","FW","32-198",1992,0.8,1,1,1,0,0,1,2,50,1,3,0,3,1,2,0,0,"https://fbref.com/en/players/b2bc3b1f/Wilfried-Zaha"
2025,"Mainz 05","Bundesliga","Nadiem Amiri","GER","MF","28-212",1996,27.5,50,23,13,28,9,19,46,41.3,27,19,4,15,16,66,30,2,"https://fbref.com/en/players/555d5edd/Nadiem-Amiri"
2025,"Mainz 05","Bundesliga","Aymen Barkok","MAR","MF","27-006",1998,0.8,2,1,1,1,0,1,1,100,0,1,1,0,2,4,0,0,"https://fbref.com/en/players/a2a85828/Aymen-Barkok"
2025,"Mainz 05","Bundesliga","Stefan Bell","GER","DF","33-276",1991,16,22,12,16,6,0,9,14,64.3,5,16,14,2,28,50,107,1,"https://fbref.com/en/players/857a5abe/Stefan-Bell"
2025,"Mainz 05","Bundesliga","Jonathan Burkardt","GER","FW","24-320",2000,23.4,15,8,1,7,7,6,10,60,4,11,1,10,1,16,14,0,"https://fbref.com/en/players/05f99a4a/Jonathan-Burkardt"
2025,"Mainz 05","Bundesliga","Anthony Caci","FRA","DF","27-330",1997,29.8,60,40,23,25,12,28,44,63.6,16,33,8,25,27,87,47,2,"https://fbref.com/en/players/0118c54c/Anthony-Caci"
2025,"Mainz 05","Bundesliga","Danny da Costa","GER","DF","31-318",1993,22.3,42,23,23,15,4,17,27,63,10,19,10,9,27,69,95,3,"https://fbref.com/en/players/5ddb8f9f/Danny-da-Costa"
2025,"Mainz 05","Bundesliga","Andreas Hanche-Olsen","NOR","DF","28-130",1997,14.3,21,13,12,8,1,9,12,75,3,25,18,7,12,33,85,2,"https://fbref.com/en/players/2e77d607/Andreas-Hanche-Olsen"
2025,"Mainz 05","Bundesliga","Hong Hyunseok","KOR","MF","25-345",1999,5.9,8,3,3,3,2,1,4,25,3,7,1,6,7,15,9,0,"https://fbref.com/en/players/9a234cc9/Hong-Hyunseok"
2025,"Mainz 05","Bundesliga","Lee Jae-sung","KOR","MF","32-290",1992,29.4,42,21,16,19,7,15,39,38.5,24,39,3,36,35,77,38,0,"https://fbref.com/en/players/34b0387f/Lee-Jae-sung"
2025,"Mainz 05","Bundesliga","Moritz Jenz","GER","DF","26-027",1999,17.8,36,20,18,18,0,16,21,76.2,5,23,14,9,30,66,128,2,"https://fbref.com/en/players/ee644761/Moritz-Jenz"
2025,"Mainz 05","Bundesliga","Dominik Kohr","GER","DF,MF","31-116",1994,25.5,62,46,34,21,7,35,55,63.6,20,43,24,19,42,104,127,0,"https://fbref.com/en/players/0fbecd11/Dominik-Kohr"
2025,"Mainz 05","Bundesliga","Maxim Leitsch","GER","DF","27-009",1998,7.5,12,4,6,4,2,7,9,77.8,2,12,4,8,10,22,42,1,"https://fbref.com/en/players/7e12a98d/Maxim-Leitsch"
2025,"Mainz 05","Bundesliga","Lennard Maloney","USA","MF","25-231",1999,0.3,2,1,0,1,1,1,1,100,0,2,0,2,0,2,3,0,"https://fbref.com/en/players/75402e99/Lennard-Maloney"
2025,"Mainz 05","Bundesliga","Phillipp Mwene","AUT","DF","31-118",1994,29,51,29,23,22,6,19,46,41.3,27,27,6,21,24,75,51,1,"https://fbref.com/en/players/2ff76adc/Phillipp-Mwene"
2025,"Mainz 05","Bundesliga","Paul Nebel","GER","MF","22-229",2002,26.1,38,24,11,18,9,11,35,31.4,24,54,4,50,13,51,30,2,"https://fbref.com/en/players/1b6d8083/Paul-Nebel"
2025,"Mainz 05","Bundesliga","Arnaud Nordin","FRA","DF,MF","26-344",1998,0.9,2,0,0,2,0,1,1,100,0,2,1,1,0,2,2,0,"https://fbref.com/en/players/7b9a9e25/Arnaud-Nordin"
2025,"Mainz 05","Bundesliga","Karim Onisiwo","AUT","MF,FW","33-071",1992,1.2,1,1,0,0,1,0,0,NA,0,0,0,0,0,1,0,0,"https://fbref.com/en/players/f26834c7/Karim-Onisiwo"
2025,"Mainz 05","Bundesliga","Lasse Rieß","GER","GK","23-304",2001,2,0,0,0,0,0,0,0,NA,0,0,0,0,0,0,5,0,"https://fbref.com/en/players/25877714/Lasse-Riess"
2025,"Mainz 05","Bundesliga","Kaishu Sano","JPN","MF","24-148",2000,33.8,61,36,22,31,8,25,52,48.1,27,66,14,52,65,126,56,1,"https://fbref.com/en/players/7a7a6361/Kaishu-Sano"
2025,"Mainz 05","Bundesliga","Armindo Sieb","GER","FW,MF","22-099",2003,8.5,10,4,4,5,1,3,10,30,7,4,0,4,1,11,7,0,"https://fbref.com/en/players/228c1d94/Armindo-Sieb"
2025,"Mainz 05","Bundesliga","Nikolas Veratschnig","AUT","DF,MF","22-123",2003,4,9,6,1,4,4,2,3,66.7,1,4,0,4,5,14,8,0,"https://fbref.com/en/players/13496b77/Nikolas-Veratschnig"
2025,"Mainz 05","Bundesliga","Gabriel Vidovic","CRO","MF","21-177",2003,0,0,0,0,0,0,0,0,NA,0,0,0,0,0,0,0,0,"https://fbref.com/en/players/5360a956/Gabriel-Vidovic"
2025,"Mainz 05","Bundesliga","Nelson Weiper","GER","FW,MF","20-071",2005,7.8,5,4,2,3,0,2,4,50,2,5,0,5,2,7,5,1,"https://fbref.com/en/players/231c67ff/Nelson-Weiper"
2025,"Mainz 05","Bundesliga","Silvan Widmer","SUI","DF","32-083",1993,5.6,11,5,3,6,2,8,12,66.7,4,7,1,6,5,16,27,0,"https://fbref.com/en/players/f68b64fc/Silvan-Widmer"
2025,"Mainz 05","Bundesliga","Robin Zentner","GER","GK","30-211",1994,32,2,1,2,0,0,1,2,50,1,0,0,0,0,2,31,4,"https://fbref.com/en/players/5c4bf6ba/Robin-Zentner"
2025,"Mallorca","La Liga","Takuma Asano","JPN","FW,MF","30-198",1994,11.7,13,9,5,7,1,6,11,54.5,5,7,0,7,6,19,9,0,"https://fbref.com/en/players/13ddc856/Takuma-Asano"
2025,"Mallorca","La Liga","Chiquinho","POR","MF,FW","25-111",2000,1.6,1,0,0,1,0,0,7,0,7,3,0,3,2,3,0,0,"https://fbref.com/en/players/dc6c2f02/Chiquinho"
2025,"Mallorca","La Liga","Copete","ESP","DF","25-229",1999,17,29,17,18,10,1,11,12,91.7,1,24,16,8,17,46,123,2,"https://fbref.com/en/players/0f26ffd7/Copete"
2025,"Mallorca","La Liga","Samu Costa","POR","MF","24-181",2000,29.4,90,44,45,42,3,35,79,44.3,44,48,15,33,32,122,85,1,"https://fbref.com/en/players/76c2a023/Samu-Costa"
2025,"Mallorca","La Liga","Sergi Darder","ESP","MF,FW","31-156",1993,30.5,40,26,15,16,9,17,46,37,29,19,1,18,16,56,23,1,"https://fbref.com/en/players/070a3904/Sergi-Darder"
2025,"Mallorca","La Liga","Marc Domenech","ESP","FW,MF","19-146",2006,3.4,4,4,2,1,1,2,5,40,3,2,0,2,0,4,2,0,"https://fbref.com/en/players/54880c9b/Marc-Domenech"
2025,"Mallorca","La Liga","Valery Fernández","ESP","MF,FW","25-185",1999,3.4,8,7,3,2,3,5,7,71.4,2,3,1,2,0,8,1,0,"https://fbref.com/en/players/4acd733a/Valery-Fernandez"
2025,"Mallorca","La Liga","Dominik Greif","SVK","GK","28-051",1997,31,0,0,0,0,0,0,0,NA,0,0,0,0,0,0,13,1,"https://fbref.com/en/players/30061f53/Dominik-Greif"
2025,"Mallorca","La Liga","Cyle Larin","CAN","FW","30-040",1995,19.6,12,6,1,6,5,3,9,33.3,6,12,3,9,1,13,16,0,"https://fbref.com/en/players/e7af9060/Cyle-Larin"
2025,"Mallorca","La Liga","Toni Lato","ESP","DF","27-187",1997,6.9,17,11,6,5,6,7,11,63.6,4,10,4,6,6,23,33,0,"https://fbref.com/en/players/8e088e04/Toni-Lato"
2025,"Mallorca","La Liga","Javier Llabrés","ESP","FW","22-258",2002,0.6,0,0,0,0,0,0,0,NA,0,1,0,1,0,0,0,0,"https://fbref.com/en/players/38b0cf42/Javier-Llabres"
2025,"Mallorca","La Liga","David López","ESP","DF","22-113",2003,1.9,3,2,3,0,0,2,2,100,0,2,2,0,1,4,10,0,"https://fbref.com/en/players/0924357d/David-Lopez"
2025,"Mallorca","La Liga","Daniel Luna","COL","MF","22-020",2003,0.2,0,0,0,0,0,0,0,NA,0,1,0,1,0,0,0,0,"https://fbref.com/en/players/410b16e3/Daniel-Luna"
2025,"Mallorca","La Liga","Pablo Maffeo","ESP","DF","27-319",1997,26.3,60,40,43,14,3,34,46,73.9,12,32,11,21,25,85,103,1,"https://fbref.com/en/players/5db04597/Pablo-Maffeo"
2025,"Mallorca","La Liga","Omar Mascarell","EQG","MF","32-114",1993,22.1,27,13,13,13,1,14,35,40,21,33,21,12,49,76,59,3,"https://fbref.com/en/players/11fd2b75/Omar-Mascarell"
2025,"Mallorca","La Liga","Johan Mojica","COL","DF","32-279",1992,30.6,35,23,26,6,3,19,40,47.5,21,13,5,8,26,61,84,3,"https://fbref.com/en/players/608f2092/Johan-Mojica"
2025,"Mallorca","La Liga","Mateu Morey","ESP","DF","25-086",2000,8.2,22,18,13,6,3,12,22,54.5,10,11,0,11,15,37,32,2,"https://fbref.com/en/players/5fd5e542/Mateu-Morey"
2025,"Mallorca","La Liga","Manu Morlanes","ESP","MF","26-135",1999,14.9,43,27,18,20,5,18,30,60,12,19,8,11,24,67,16,0,"https://fbref.com/en/players/a0255c67/Manu-Morlanes"
2025,"Mallorca","La Liga","Vedat Muriqi","KVX","FW","31-033",1994,22.9,7,5,3,2,2,3,7,42.9,4,7,1,6,7,14,43,0,"https://fbref.com/en/players/0cadc46d/Vedat-Muriqi"
2025,"Mallorca","La Liga","Roberto Navarro","ESP","MF,FW","23-045",2002,14.2,29,22,14,11,4,9,19,47.4,10,18,0,18,19,48,12,0,"https://fbref.com/en/players/c997b942/Roberto-Navarro"
2025,"Mallorca","La Liga","Abdón Prats","ESP","FW,MF","32-171",1992,5.1,2,1,1,1,0,1,2,50,1,2,1,1,1,3,5,0,"https://fbref.com/en/players/d1b060e2/Abdon-Prats"
2025,"Mallorca","La Liga","Antonio Raillo","ESP","DF","33-231",1991,35.6,31,18,18,10,3,14,20,70,6,51,38,13,29,60,222,1,"https://fbref.com/en/players/b857bd29/Antonio-Raillo"
2025,"Mallorca","La Liga","Dani Rodríguez","ESP","MF,FW","36-355",1988,24,49,29,18,21,10,14,27,51.9,13,22,3,19,12,61,30,0,"https://fbref.com/en/players/70f8e0bd/Dani-Rodriguez"
2025,"Mallorca","La Liga","Leo Román","ESP","GK","24-325",2000,7,0,0,0,0,0,0,0,NA,0,0,0,0,0,0,6,0,"https://fbref.com/en/players/924ff27e/Leo-Roman"
2025,"Mallorca","La Liga","Jan Salas","ESP","MF,FW","19-290",2005,0.5,3,1,2,1,0,2,2,100,0,0,0,0,0,3,0,0,"https://fbref.com/en/players/59bb99d1/Jan-Salas"
2025,"Mallorca","La Liga","Antonio Sánchez","ESP","MF,DF","28-146",1997,15.5,28,16,16,8,4,14,36,38.9,22,16,2,14,18,46,36,1,"https://fbref.com/en/players/a254bbe0/Antonio-Sanchez"
2025,"Mallorca","La Liga","Martin Valjent","SVK","DF","29-167",1995,30.7,30,21,22,7,1,15,25,60,10,32,21,11,18,48,195,1,"https://fbref.com/en/players/f2c6ac01/Martin-Valjent"
2025,"Mallorca","La Liga","Siebe Van Der Heyden","BEL","DF,MF","26-362",1998,1.1,1,1,0,1,0,0,0,NA,0,1,0,1,2,3,3,0,"https://fbref.com/en/players/cf9bdd43/Siebe-Van-Der-Heyden"
2025,"Manchester City","Premier League","Manuel Akanji","SUI","DF","29-312",1995,22.4,19,12,12,4,3,11,17,64.7,6,11,8,3,9,28,64,3,"https://fbref.com/en/players/89ac64a6/Manuel-Akanji"
2025,"Manchester City","Premier League","Nathan Aké","NED","DF","30-098",1995,7.5,9,7,7,2,0,4,6,66.7,2,7,2,5,3,12,22,1,"https://fbref.com/en/players/eaeca114/Nathan-Ake"
2025,"Manchester City","Premier League","Oscar Bobb","NOR","FW","21-319",2003,0.2,0,0,0,0,0,0,0,NA,0,0,0,0,0,0,0,0,"https://fbref.com/en/players/eed2427e/Oscar-Bobb"
2025,"Manchester City","Premier League","Kevin De Bruyne","BEL","MF,FW","33-333",1991,18.9,17,9,7,5,5,5,23,21.7,18,8,0,8,7,24,10,1,"https://fbref.com/en/players/e46012d4/Kevin-De-Bruyne"
2025,"Manchester City","Premier League","Rúben Dias","POR","DF","28-013",1997,25.2,17,11,7,9,1,7,13,53.8,6,23,20,3,20,37,71,4,"https://fbref.com/en/players/31c69ef1/Ruben-Dias"
2025,"Manchester City","Premier League","Jeremy Doku","BEL","FW,MF","23-000",2002,16.8,31,22,9,12,10,8,15,53.3,7,11,1,10,4,35,2,0,"https://fbref.com/en/players/fffea3e5/Jeremy-Doku"
2025,"Manchester City","Premier League","Claudio Echeverri","ARG","FW","19-145",2006,0.1,1,0,0,1,0,1,1,100,0,0,0,0,0,1,0,0,"https://fbref.com/en/players/49a605df/Claudio-Echeverri"
2025,"Manchester City","Premier League","Ederson","BRA","GK","31-283",1993,25.8,0,0,0,0,0,0,2,0,2,0,0,0,1,1,11,4,"https://fbref.com/en/players/3bb7b8b4/Ederson"
2025,"Manchester City","Premier League","Phil Foden","ENG","MF,FW","24-364",2000,19.7,13,5,5,4,4,7,18,38.9,11,13,1,12,9,22,7,1,"https://fbref.com/en/players/ed1e53f3/Phil-Foden"
2025,"Manchester City","Premier League","Nicolás González","ESP","MF","23-144",2002,8.4,16,6,5,7,4,6,11,54.5,5,9,0,9,8,24,21,0,"https://fbref.com/en/players/2c56a792/Nicolas-Gonzalez"
2025,"Manchester City","Premier League","Jack Grealish","ENG","FW,MF","29-259",1995,8,9,5,4,2,3,2,5,40,3,12,2,10,2,11,6,1,"https://fbref.com/en/players/b0b4fd3e/Jack-Grealish"
2025,"Manchester City","Premier League","İlkay Gündoğan","GER","MF","34-215",1990,24.7,25,13,5,15,5,10,24,41.7,14,15,0,15,13,38,23,0,"https://fbref.com/en/players/819b3158/Ilkay-Gundogan"
2025,"Manchester City","Premier League","Joško Gvardiol","CRO","DF","23-124",2002,36.4,58,39,25,21,12,21,40,52.5,19,42,20,22,44,102,122,8,"https://fbref.com/en/players/5ad50391/Josko-Gvardiol"
2025,"Manchester City","Premier League","Erling Haaland","NOR","FW","24-310",2000,30.4,11,6,3,3,5,3,8,37.5,5,12,1,11,5,16,23,0,"https://fbref.com/en/players/1f44ac21/Erling-Haaland"
2025,"Manchester City","Premier League","Abdukodir Khusanov","UZB","DF","21-087",2004,5.6,5,4,4,1,0,2,3,66.7,1,5,4,1,3,8,29,1,"https://fbref.com/en/players/d17ce930/Abdukodir-Khusanov"
2025,"Manchester City","Premier League","Mateo Kovačić","CRO","MF","31-021",1994,24.4,69,38,23,38,8,31,65,47.7,34,20,0,20,24,93,21,1,"https://fbref.com/en/players/79c0821a/Mateo-Kovacic"
2025,"Manchester City","Premier League","Rico Lewis","ENG","DF,MF","20-187",2004,21,30,19,13,12,5,13,21,61.9,8,28,7,21,13,43,45,1,"https://fbref.com/en/players/b57e066e/Rico-Lewis"
2025,"Manchester City","Premier League","Omar Marmoush","EGY","FW,MF","26-109",1999,13.1,13,8,2,9,2,8,16,50,8,15,1,14,6,19,3,0,"https://fbref.com/en/players/0e0102eb/Omar-Marmoush"
2025,"Manchester City","Premier League","James Mcatee","ENG","MF,FW","22-221",2002,3.9,5,2,0,4,1,1,7,14.3,6,8,0,8,2,7,1,0,"https://fbref.com/en/players/96593e89/James-Mcatee"
2025,"Manchester City","Premier League","Divin Mubama","ENG","FW","20-214",2004,0.3,0,0,0,0,0,0,0,NA,0,0,0,0,0,0,0,0,"https://fbref.com/en/players/92868cb5/Divin-Mubama"
2025,"Manchester City","Premier League","Matheus Nunes","POR","DF,MF","26-273",1998,18.6,35,22,15,14,6,16,38,42.1,22,17,4,13,15,50,38,2,"https://fbref.com/en/players/e6af02e0/Matheus-Nunes"
2025,"Manchester City","Premier League","Stefan Ortega","GER","GK","32-202",1992,12.2,0,0,0,0,0,0,1,0,1,0,0,0,0,0,11,1,"https://fbref.com/en/players/c1242d4e/Stefan-Ortega"
2025,"Manchester City","Premier League","Nico O’Reilly","ENG","DF","20-067",2005,5.9,9,4,3,3,3,4,8,50,4,5,1,4,4,13,12,0,"https://fbref.com/en/players/91ca4a16/Nico-OReilly"
2025,"Manchester City","Premier League","Vitor Reis","BRA","DF","19-135",2006,0,0,0,0,0,0,0,0,NA,0,0,0,0,0,0,1,0,"https://fbref.com/en/players/c4ce0ab5/Vitor-Reis"
2025,"Manchester City","Premier League","Rodri","ESP","MF","28-339",1996,0.8,2,1,1,1,0,0,0,NA,0,1,0,1,1,3,1,0,"https://fbref.com/en/players/6434f10d/Rodri"
2025,"Manchester City","Premier League","Sávio","BRA","FW,MF","21-047",2004,19.6,23,17,5,10,8,10,19,52.6,9,14,2,12,6,29,9,1,"https://fbref.com/en/players/fe6e7156/Savio"
2025,"Manchester City","Premier League","Bernardo Silva","POR","MF,FW","30-290",1994,29.7,56,37,17,30,9,25,56,44.6,31,36,7,29,23,79,32,3,"https://fbref.com/en/players/3eb22ec9/Bernardo-Silva"
2025,"Manchester City","Premier League","Jahmai Simpson-Pusey","ENG","DF","19-204",2005,1.1,1,0,1,0,0,0,1,0,1,1,1,0,0,1,2,0,"https://fbref.com/en/players/383b10fd/Jahmai-Simpson-Pusey"
2025,"Manchester City","Premier League","John Stones","ENG","DF,MF","30-364",1994,6.1,6,2,3,2,1,5,5,100,0,5,3,2,4,10,19,1,"https://fbref.com/en/players/5eecec3d/John-Stones"
2025,"Manchester City","Premier League","Kyle Walker","ENG","DF","34-364",1990,10.8,17,10,7,7,3,14,26,53.8,12,13,4,9,3,20,13,1,"https://fbref.com/en/players/86dd77d1/Kyle-Walker"
2025,"Manchester Utd","Premier League","Harry Amass","ENG","DF","18-072",2007,3.8,6,2,5,1,0,2,8,25,6,11,1,10,2,8,11,0,"https://fbref.com/en/players/7b47100c/Harry-Amass"
2025,"Manchester Utd","Premier League","Antony","BRA","DF,MF","25-092",2000,1.6,6,3,4,2,0,2,5,40,3,2,0,2,2,8,0,0,"https://fbref.com/en/players/99127249/Antony"
2025,"Manchester Utd","Premier League","Altay Bayındır","TUR","GK","27-043",1998,4,0,0,0,0,0,0,1,0,1,0,0,0,0,0,9,1,"https://fbref.com/en/players/072e68ed/Altay-Bayindir"
2025,"Manchester Utd","Premier League","Casemiro","BRA","MF","33-093",1992,16.6,83,50,50,23,10,45,74,60.8,29,39,10,29,14,97,51,3,"https://fbref.com/en/players/4d224fe8/Casemiro"
2025,"Manchester Utd","Premier League","Toby Collyer","ENG","MF","21-144",2004,2,12,9,6,6,0,5,6,83.3,1,2,1,1,2,14,3,0,"https://fbref.com/en/players/4f9091bc/Toby-Collyer"
2025,"Manchester Utd","Premier League","Diogo Dalot","POR","DF","26-070",1999,31.3,68,40,40,22,6,34,52,65.4,18,22,9,13,37,105,72,0,"https://fbref.com/en/players/d9565625/Diogo-Dalot"
2025,"Manchester Utd","Premier League","Amad Diallo","CIV","MF,FW","22-320",2002,21.1,38,31,9,20,9,19,32,59.4,13,15,2,13,11,49,19,1,"https://fbref.com/en/players/9dc96f10/Amad-Diallo"
2025,"Manchester Utd","Premier League","Patrick Dorgu","DEN","DF","20-213",2004,9.4,31,24,15,14,2,16,23,69.6,7,11,0,11,4,35,23,2,"https://fbref.com/en/players/e6536124/Patrick-Dorgu"
2025,"Manchester Utd","Premier League","Christian Eriksen","DEN","MF","33-102",1992,11.8,19,9,4,12,3,11,27,40.7,16,15,5,10,7,26,8,0,"https://fbref.com/en/players/980522ec/Christian-Eriksen"
2025,"Manchester Utd","Premier League","Jonny Evans","NIR","DF","37-144",1988,3.5,8,6,4,4,0,3,6,50,3,3,2,1,5,13,15,0,"https://fbref.com/en/players/f8fcd2a5/Jonny-Evans"
2025,"Manchester Utd","Premier League","Bruno Fernandes","POR","MF","30-261",1994,33.5,84,50,27,38,19,34,85,40,51,35,6,29,26,110,35,3,"https://fbref.com/en/players/507c7bdf/Bruno-Fernandes"
2025,"Manchester Utd","Premier League","Tyler Fredricson","ENG","DF","20-093",2005,1.8,5,3,3,2,0,1,2,50,1,2,0,2,1,6,11,0,"https://fbref.com/en/players/58630379/Tyler-Fredricson"
2025,"Manchester Utd","Premier League","Alejandro Garnacho","ARG","MF,FW","20-330",2004,24.4,30,18,11,6,13,12,37,32.4,25,19,0,19,13,43,11,2,"https://fbref.com/en/players/7aa8adfe/Alejandro-Garnacho"
2025,"Manchester Utd","Premier League","Ayden Heaven","ENG","DF","18-247",2006,1.9,4,3,1,3,0,2,2,100,0,2,2,0,4,8,9,0,"https://fbref.com/en/players/64e17fab/Ayden-Heaven"
2025,"Manchester Utd","Premier League","Rasmus Højlund","DEN","FW","22-112",2003,22.3,3,1,0,2,1,0,5,0,5,6,0,6,2,5,6,0,"https://fbref.com/en/players/491a433d/Rasmus-Hojlund"
2025,"Manchester Utd","Premier League","Matthijs de Ligt","NED","DF","25-288",1999,23.6,30,22,17,12,1,23,32,71.9,9,29,21,8,33,63,96,0,"https://fbref.com/en/players/d6e53a3a/Matthijs-de-Ligt"
2025,"Manchester Utd","Premier League","Victor Lindelöf","SWE","DF","30-314",1994,7.8,7,2,5,1,1,3,4,75,1,6,4,2,8,15,36,2,"https://fbref.com/en/players/f5deef4c/Victor-Lindelof"
2025,"Manchester Utd","Premier League","Harry Maguire","ENG","DF","32-083",1993,19.5,30,15,23,6,1,17,23,73.9,6,15,12,3,40,70,78,1,"https://fbref.com/en/players/d8931174/Harry-Maguire"
2025,"Manchester Utd","Premier League","Kobbie Mainoo","ENG","MF","20-038",2005,18.3,46,29,18,14,14,24,40,60,16,16,2,14,19,65,14,1,"https://fbref.com/en/players/c6220452/Kobbie-Mainoo"
2025,"Manchester Utd","Premier League","Tyrell Malacia","NED","DF","25-283",1999,1.1,2,1,2,0,0,1,2,50,1,0,0,0,1,3,1,1,"https://fbref.com/en/players/6b6c793c/Tyrell-Malacia"
2025,"Manchester Utd","Premier League","Lisandro Martínez","ARG","DF","27-129",1998,19.5,40,24,25,12,3,21,36,58.3,15,22,8,14,32,72,57,1,"https://fbref.com/en/players/bac46a10/Lisandro-Martinez"
2025,"Manchester Utd","Premier League","Noussair Mazraoui","MAR","DF","27-194",1997,31.5,115,68,58,42,15,59,94,62.8,35,36,9,27,34,149,95,1,"https://fbref.com/en/players/b74277a0/Noussair-Mazraoui"
2025,"Manchester Utd","Premier League","Scott McTominay","SCO","MF","28-170",1996,0.2,0,0,0,0,0,0,1,0,1,0,0,0,0,0,1,0,"https://fbref.com/en/players/d93c2511/Scott-McTominay"
2025,"Manchester Utd","Premier League","Mason Mount","ENG","MF","26-137",1999,6.9,15,5,5,8,2,9,12,75,3,11,1,10,4,19,4,0,"https://fbref.com/en/players/9674002f/Mason-Mount"
2025,"Manchester Utd","Premier League","Chidozie Obi-Martin","DEN","FW","17-179",2007,1.8,2,1,0,0,2,2,2,100,0,0,0,0,0,2,1,0,"https://fbref.com/en/players/0c9bfc3b/Chidozie-Obi-Martin"
2025,"Manchester Utd","Premier League","André Onana","CMR","GK","29-055",1996,34,2,2,2,0,0,2,4,50,2,0,0,0,0,2,11,4,"https://fbref.com/en/players/e9c0c1b2/Andre-Onana"
2025,"Manchester Utd","Premier League","Marcus Rashford","ENG","FW,MF","27-208",1997,10.9,7,4,2,2,3,3,9,33.3,6,8,0,8,4,11,7,0,"https://fbref.com/en/players/a1d5bd30/Marcus-Rashford"
2025,"Manchester Utd","Premier League","Luke Shaw","ENG","DF","29-319",1995,3.9,4,3,2,2,0,2,2,100,0,6,1,5,2,6,7,0,"https://fbref.com/en/players/9c94165b/Luke-Shaw"
2025,"Manchester Utd","Premier League","Manuel Ugarte Ribeiro","URU","MF","24-046",2001,19.8,77,49,34,34,9,30,68,44.1,38,33,4,29,27,104,17,2,"https://fbref.com/en/players/c9817014/Manuel-Ugarte-Ribeiro"
2025,"Manchester Utd","Premier League","Leny Yoro","FRA","DF","19-195",2005,12.9,29,11,19,9,1,13,19,68.4,6,5,3,2,18,47,43,0,"https://fbref.com/en/players/6763f716/Leny-Yoro"
2025,"Manchester Utd","Premier League","Joshua Zirkzee","NED","FW,MF","24-005",2001,15.6,14,8,3,8,3,5,10,50,5,15,4,11,6,20,8,1,"https://fbref.com/en/players/028e70b9/Joshua-Zirkzee"
2025,"Marseille","Ligue 1","Keyliane Abdallah","FRA","FW","19-052",2006,0,1,1,1,0,0,1,1,100,0,0,0,0,0,1,0,0,"https://fbref.com/en/players/7310786d/Keyliane-Abdallah"
2025,"Marseille","Ligue 1","Michael Amir Murillo","PAN","DF","29-105",1996,27.1,49,31,30,13,6,32,46,69.6,14,21,8,13,18,67,70,4,"https://fbref.com/en/players/349cae8f/Michael-Amir-Murillo"
2025,"Marseille","Ligue 1","Darryl Bakola","FRA","DF,MF","17-178",2007,0.2,1,1,0,1,0,0,0,NA,0,0,0,0,0,1,0,0,"https://fbref.com/en/players/57de24a3/Darryl-Bakola"
2025,"Marseille","Ligue 1","Leonardo Balerdi","ARG","DF","26-121",1999,25.3,54,39,32,17,5,27,47,57.4,20,25,14,11,38,92,72,4,"https://fbref.com/en/players/7c3ed041/Leonardo-Balerdi"
2025,"Marseille","Ligue 1","Ismaël Bennacer","ALG","MF","27-177",1997,7.2,21,10,8,12,1,12,18,66.7,6,6,0,6,10,31,2,1,"https://fbref.com/en/players/db092d3b/Ismael-Bennacer"
2025,"Marseille","Ligue 1","Lilian Brassier","FRA","DF","25-206",1999,8.7,8,6,8,0,0,5,6,83.3,1,8,3,5,9,17,28,2,"https://fbref.com/en/players/5b146df3/Lilian-Brassier"
2025,"Marseille","Ligue 1","Valentin Carboni","ARG","MF,FW","20-083",2005,1.1,2,2,0,1,1,0,1,0,1,1,0,1,1,3,1,0,"https://fbref.com/en/players/707b98f1/Valentin-Carboni"
2025,"Marseille","Ligue 1","Derek Cornelius","CAN","DF","27-183",1997,15.8,24,17,15,8,1,17,22,77.3,5,16,10,6,14,38,51,0,"https://fbref.com/en/players/577744b8/Derek-Cornelius"
2025,"Marseille","Ligue 1","Amar Dedić","BIH","DF","22-282",2002,3.5,5,4,2,2,1,3,10,30,7,0,0,0,3,8,12,1,"https://fbref.com/en/players/bc6e544a/Amar-Dedic"
2025,"Marseille","Ligue 1","Luiz Felipe","ITA","DF","28-066",1997,1.4,4,3,3,1,0,1,2,50,1,3,2,1,3,7,5,0,"https://fbref.com/en/players/15d0c248/Luiz-Felipe"
2025,"Marseille","Ligue 1","Ulisses Garcia","SUI","DF","29-136",1996,10.3,14,11,7,5,2,4,14,28.6,10,5,1,4,8,22,18,0,"https://fbref.com/en/players/c952f633/Ulisses-Garcia"
2025,"Marseille","Ligue 1","Amine Gouiri","ALG","FW,MF","25-100",2000,11.6,5,5,0,1,4,2,3,66.7,1,9,0,9,1,6,1,0,"https://fbref.com/en/players/aad56ca3/Amine-Gouiri"
2025,"Marseille","Ligue 1","Mason Greenwood","ENG","FW,MF","23-238",2001,31.2,35,18,10,14,11,16,39,41,23,7,0,7,12,47,5,2,"https://fbref.com/en/players/58eee997/Mason-Greenwood"
2025,"Marseille","Ligue 1","Amine Harit","MAR","MF","27-343",1997,5.8,8,7,0,6,2,1,2,50,1,6,0,6,3,11,1,1,"https://fbref.com/en/players/e7d59f4f/Amine-Harit"
2025,"Marseille","Ligue 1","Luis Henrique","BRA","DF,FW","23-164",2001,29,16,9,7,6,3,9,10,90,1,15,2,13,10,26,30,0,"https://fbref.com/en/players/f36d5624/Luis-Henrique"
2025,"Marseille","Ligue 1","Pierre Højbjerg","DEN","MF","29-295",1995,29.6,64,45,25,32,7,37,69,53.6,32,28,4,24,42,106,33,2,"https://fbref.com/en/players/8b04d6c1/Pierre-Hojbjerg"
2025,"Marseille","Ligue 1","Geoffrey Kondogbia","CTA","DF,MF","32-101",1993,22.4,60,38,31,26,3,27,34,79.4,7,23,6,17,22,82,64,4,"https://fbref.com/en/players/cce181df/Geoffrey-Kondogbia"
2025,"Marseille","Ligue 1","Ismaël Koné","CAN","MF,FW","22-355",2002,4,8,4,3,3,2,3,4,75,1,4,1,3,4,12,2,1,"https://fbref.com/en/players/e0220b70/Ismael-Kone"
2025,"Marseille","Ligue 1","Emmanuel Koum Mbondo","FRA","DF","19-111",2006,0.1,0,0,0,0,0,0,0,NA,0,0,0,0,0,0,0,0,"https://fbref.com/en/players/cb3c6ca9/Emmanuel-Koum-Mbondo"
2025,"Marseille","Ligue 1","Pol Lirola","ESP","DF","27-287",1997,7.6,13,9,5,8,0,5,13,38.5,8,7,2,5,4,17,12,0,"https://fbref.com/en/players/ff800ed8/Pol-Lirola"
2025,"Marseille","Ligue 1","Neal Maupay","FRA","FW","28-286",1996,11.6,9,4,1,6,2,3,6,50,3,5,0,5,2,11,0,0,"https://fbref.com/en/players/4bcf39f6/Neal-Maupay"
2025,"Marseille","Ligue 1","Bamo Meïté","CIV","DF","23-175",2001,0.3,0,0,0,0,0,0,0,NA,0,0,0,0,0,0,1,0,"https://fbref.com/en/players/04ac78d2/Bamo-Meite"
2025,"Marseille","Ligue 1","Quentin Merlin","FRA","DF","23-011",2002,17.7,22,17,12,5,5,9,16,56.3,7,20,4,16,14,36,17,1,"https://fbref.com/en/players/0bfca6a1/Quentin-Merlin"
2025,"Marseille","Ligue 1","Bilal Nadir","MAR","MF","21-180",2003,4.3,10,3,4,6,0,4,6,66.7,2,6,1,5,4,14,7,0,"https://fbref.com/en/players/226673c2/Bilal-Nadir"
2025,"Marseille","Ligue 1","Faris Pemi Moumbagna","CMR","FW","24-330",2000,0.1,0,0,0,0,0,0,0,NA,0,0,0,0,0,0,0,0,"https://fbref.com/en/players/58aae0a9/Faris-Pemi-Moumbagna"
2025,"Marseille","Ligue 1","Adrien Rabiot","FRA","MF","30-054",1995,27.6,49,31,17,21,11,19,32,59.4,13,21,2,19,21,70,32,0,"https://fbref.com/en/players/8794e251/Adrien-Rabiot"
2025,"Marseille","Ligue 1","Valentin Rongier","FRA","MF,DF","30-171",1994,17.4,50,28,14,31,5,27,43,62.8,16,30,9,21,33,83,28,5,"https://fbref.com/en/players/ed45c4a5/Valentin-Rongier"
2025,"Marseille","Ligue 1","Jon Rowe","ENG","FW,MF","22-027",2003,9,15,11,5,4,6,6,14,42.9,8,4,1,3,2,17,4,0,"https://fbref.com/en/players/8c12f884/Jon-Rowe"
2025,"Marseille","Ligue 1","Gerónimo Rulli","ARG","GK","33-007",1992,34,4,3,4,0,0,4,8,50,4,1,0,1,1,5,25,3,"https://fbref.com/en/players/625c144a/Geronimo-Rulli"
2025,"Marseille","Ligue 1","Enzo Sternal","FRA","FW,MF","17-364",2007,0.3,0,0,0,0,0,0,0,NA,0,0,0,0,0,0,0,0,"https://fbref.com/en/players/c2e3ceb7/Enzo-Sternal"
2025,"Marseille","Ligue 1","Robinio Vaz","FRA","FW","18-099",2007,0.8,1,1,0,0,1,0,2,0,2,0,0,0,0,1,2,0,"https://fbref.com/en/players/74fb9321/Robinio-Vaz"
2025,"Marseille","Ligue 1","Elye Wahi","FRA","FW","22-145",2003,6.4,0,0,0,0,0,0,4,0,4,1,0,1,1,1,0,0,"https://fbref.com/en/players/0d7b6576/Elye-Wahi"
2025,"Milan","Serie A","Tammy Abraham","ENG","FW","27-237",1997,13.1,17,11,2,10,5,6,8,75,2,13,0,13,2,19,16,0,"https://fbref.com/en/players/f586779e/Tammy-Abraham"
2025,"Milan","Serie A","Davide Bartesaghi","ITA","DF","19-149",2005,1.3,4,2,1,1,2,4,4,100,0,1,1,0,3,7,1,0,"https://fbref.com/en/players/7e0b6c50/Davide-Bartesaghi"
2025,"Milan","Serie A","Ismaël Bennacer","ALG","MF","27-177",1997,3.3,5,4,1,3,1,1,7,14.3,6,5,3,2,3,8,1,0,"https://fbref.com/en/players/db092d3b/Ismael-Bennacer"
2025,"Milan","Serie A","Warren Bondo","FRA","MF","21-254",2003,1.8,5,3,4,1,0,3,3,100,0,1,0,1,0,5,2,0,"https://fbref.com/en/players/0def2376/Warren-Bondo"
2025,"Milan","Serie A","Davide Calabria","ITA","DF","28-172",1996,3.5,10,7,10,0,0,4,7,57.1,3,1,0,1,8,18,8,0,"https://fbref.com/en/players/2146785a/Davide-Calabria"
2025,"Milan","Serie A","Francesco Camarda","ITA","FW,MF","17-078",2008,2.3,5,2,0,2,3,2,6,33.3,4,2,1,1,0,5,3,0,"https://fbref.com/en/players/1956a64b/Francesco-Camarda"
2025,"Milan","Serie A","Samuel Chukwueze","NGA","FW,MF","26-005",1999,10.3,17,11,7,6,4,5,19,26.3,14,3,0,3,2,19,9,0,"https://fbref.com/en/players/b8a642fc/Samuel-Chukwueze"
2025,"Milan","Serie A","Emerson","BRA","DF","26-133",1999,15.3,45,28,24,16,5,16,34,47.1,18,13,2,11,14,59,56,0,"https://fbref.com/en/players/df8b52a5/Emerson"
2025,"Milan","Serie A","João Félix","POR","MF","25-198",1999,8.4,6,6,3,2,1,4,14,28.6,10,2,0,2,1,7,9,0,"https://fbref.com/en/players/8aafd64f/Joao-Felix"
2025,"Milan","Serie A","Alessandro Florenzi","ITA","FW","34-077",1991,0.1,0,0,0,0,0,0,0,NA,0,0,0,0,0,0,0,0,"https://fbref.com/en/players/e288d4b3/Alessandro-Florenzi"
2025,"Milan","Serie A","Youssouf Fofana","FRA","MF","26-137",1999,27.8,56,34,20,31,5,26,52,50,26,32,9,23,19,75,24,3,"https://fbref.com/en/players/822d51d7/Youssouf-Fofana"
2025,"Milan","Serie A","Matteo Gabbia","ITA","DF","25-218",1999,23.9,21,15,13,7,1,8,10,80,2,25,19,6,15,36,103,1,"https://fbref.com/en/players/c235e803/Matteo-Gabbia"
2025,"Milan","Serie A","Santiago Giménez","MEX","FW","24-039",2001,7.4,5,3,0,4,1,3,4,75,1,3,1,2,1,6,13,0,"https://fbref.com/en/players/37337aea/Santiago-Gimenez"
2025,"Milan","Serie A","Theo Hernández","FRA","DF","27-233",1997,30,36,28,23,10,3,21,39,53.8,18,25,10,15,17,53,75,3,"https://fbref.com/en/players/d4c9725f/Theo-Hernandez"
2025,"Milan","Serie A","Alejandro Jiménez","ESP","DF,FW","20-019",2005,14.1,24,13,8,14,2,11,27,40.7,16,24,3,21,15,39,23,0,"https://fbref.com/en/players/faa13947/Alejandro-Jimenez"
2025,"Milan","Serie A","Luka Jović","SRB","FW,MF","27-155",1997,6.2,0,0,0,0,0,0,0,NA,0,2,1,1,1,1,3,0,"https://fbref.com/en/players/4d8cd038/Luka-Jovic"
2025,"Milan","Serie A","Rafael Leão","POR","FW","25-351",1999,25.8,16,10,4,8,4,11,29,37.9,18,15,1,14,6,22,4,0,"https://fbref.com/en/players/20730eae/Rafael-Leao"
2025,"Milan","Serie A","Mattia Liberali","ITA","MF","18-051",2007,0.7,2,1,0,1,1,2,2,100,0,0,0,0,0,2,0,0,"https://fbref.com/en/players/775f4a87/Mattia-Liberali"
2025,"Milan","Serie A","Ruben Loftus-Cheek","ENG","MF","29-124",1996,11.5,19,8,6,9,4,6,12,50,6,3,0,3,3,22,20,0,"https://fbref.com/en/players/e97fd090/Ruben-Loftus-Cheek"
2025,"Milan","Serie A","Mike Maignan","FRA","GK","29-328",1995,36.6,0,0,0,0,0,0,1,0,1,1,0,1,0,0,19,3,"https://fbref.com/en/players/fcb38f57/Mike-Maignan"
2025,"Milan","Serie A","Álvaro Morata","ESP","FW,MF","32-216",1992,12.2,16,10,5,8,3,5,8,62.5,3,7,2,5,5,21,5,0,"https://fbref.com/en/players/129af0db/Alvaro-Morata"
2025,"Milan","Serie A","Bob Murphy Omoregbe","ITA","MF","21-203",2003,0,0,0,0,0,0,0,0,NA,0,0,0,0,0,0,0,0,"https://fbref.com/en/players/b04364ed/Bob-Murphy-Omoregbe"
2025,"Milan","Serie A","Yunus Musah","USA","MF,FW","22-179",2002,17.5,27,19,13,9,5,12,17,70.6,5,9,1,8,7,34,9,3,"https://fbref.com/en/players/b51b1b9c/Yunus-Musah"
2025,"Milan","Serie A","Noah Okafor","SUI","FW","25-003",2000,4.6,2,1,0,0,2,0,1,0,1,1,0,1,2,4,1,0,"https://fbref.com/en/players/ca607d59/Noah-Okafor"
2025,"Milan","Serie A","Strahinja Pavlović","SRB","DF","24-003",2001,20.7,52,31,32,19,1,29,50,58,21,17,6,11,16,68,82,0,"https://fbref.com/en/players/25146df0/Strahinja-Pavlovic"
2025,"Milan","Serie A","Christian Pulisic","USA","FW,MF","26-251",1998,27.5,43,29,17,14,12,15,37,40.5,22,24,2,22,5,48,13,2,"https://fbref.com/en/players/1bf33a9a/Christian-Pulisic"
2025,"Milan","Serie A","Tijjani Reijnders","NED","MF","26-302",1998,34.8,26,13,6,14,6,10,26,38.5,16,22,4,18,38,64,28,2,"https://fbref.com/en/players/afb61630/Tijjani-Reijnders"
2025,"Milan","Serie A","Alexis Saelemaekers","BEL","DF,FW","25-334",1999,1,1,1,0,0,1,1,1,100,0,0,0,0,1,2,0,0,"https://fbref.com/en/players/ee251371/Alexis-Saelemaekers"
2025,"Milan","Serie A","Riccardo Sottil","ITA","FW,MF","25-358",1999,1.4,1,1,1,0,0,0,0,NA,0,0,0,0,0,1,0,0,"https://fbref.com/en/players/94816803/Riccardo-Sottil"
2025,"Milan","Serie A","Marco Sportiello","ITA","GK","33-017",1992,1.4,0,0,0,0,0,0,0,NA,0,0,0,0,0,0,1,0,"https://fbref.com/en/players/ac4003af/Marco-Sportiello"
2025,"Milan","Serie A","Filippo Terracciano","ITA","DF,MF","22-108",2003,6,9,6,1,6,2,5,10,50,5,1,0,1,6,15,11,0,"https://fbref.com/en/players/5cbb5ad6/Filippo-Terracciano"
2025,"Milan","Serie A","Malick Thiaw","GER","DF","23-292",2001,20.1,24,17,15,6,3,6,10,60,4,14,12,2,15,39,76,1,"https://fbref.com/en/players/ff5ea0bf/Malick-Thiaw"
2025,"Milan","Serie A","Fikayo Tomori","ENG","DF","27-159",1997,17.7,40,25,21,16,3,17,25,68,8,17,12,5,20,60,61,2,"https://fbref.com/en/players/7edfbb8a/Fikayo-Tomori"
2025,"Milan","Serie A","Kyle Walker","ENG","DF","34-364",1990,7.3,17,9,12,4,1,13,17,76.5,4,9,5,4,9,26,15,1,"https://fbref.com/en/players/86dd77d1/Kyle-Walker"
2025,"Milan","Serie A","Kevin Zeroli","ITA","MF","20-136",2005,0.1,1,1,0,1,0,0,0,NA,0,0,0,0,0,1,0,0,"https://fbref.com/en/players/7d6d4395/Kevin-Zeroli"
2025,"Monaco","Ligue 1","Maghnes Akliouche","FRA","FW,MF","23-091",2002,26.7,51,31,12,24,15,19,41,46.3,22,21,0,21,15,66,13,0,"https://fbref.com/en/players/b625b241/Maghnes-Akliouche"
2025,"Monaco","Ligue 1","Folarin Balogun","USA","FW","23-328",2001,6.8,1,1,0,0,1,0,4,0,4,0,0,0,1,2,0,0,"https://fbref.com/en/players/31822f8c/Folarin-Balogun"
2025,"Monaco","Ligue 1","Eliesse Ben Seghir","MAR","MF,FW","20-100",2005,19.4,31,22,12,12,7,18,32,56.3,14,20,0,20,13,44,4,0,"https://fbref.com/en/players/3bd65247/Eliesse-Ben-Seghir"
2025,"Monaco","Ligue 1","Mika Biereth","DEN","FW","22-108",2003,13.6,5,5,0,3,2,3,7,42.9,4,11,0,11,4,9,7,0,"https://fbref.com/en/players/a1d95db3/Mika-Biereth"
2025,"Monaco","Ligue 1","Saïmon Bouabré","FRA","MF,FW","18-360",2006,1.1,1,0,0,1,0,0,3,0,3,1,0,1,0,1,0,0,"https://fbref.com/en/players/f40e77d9/Saimon-Bouabre"
2025,"Monaco","Ligue 1","Lamine Camara","SEN","MF","21-146",2004,22.8,66,41,22,34,10,26,48,54.2,22,30,4,26,31,97,32,1,"https://fbref.com/en/players/19c2ffa4/Lamine-Camara"
2025,"Monaco","Ligue 1","Mamadou Coulibaly","FRA","MF","21-036",2004,0.1,1,0,0,1,0,0,0,NA,0,0,0,0,0,1,0,0,"https://fbref.com/en/players/dacf856a/Mamadou-Coulibaly"
2025,"Monaco","Ligue 1","Krépin Diatta","SEN","DF,FW","26-091",1999,5.6,18,12,13,2,3,14,24,58.3,10,5,1,4,9,27,12,2,"https://fbref.com/en/players/8104e41e/Krepin-Diatta"
2025,"Monaco","Ligue 1","Breel Embolo","SUI","FW,MF","28-102",1997,20.5,22,17,7,7,8,5,16,31.3,11,11,0,11,3,25,10,1,"https://fbref.com/en/players/0b4f388a/Breel-Embolo"
2025,"Monaco","Ligue 1","Aleksandr Golovin","RUS","MF,FW","28-362",1996,12.8,38,24,9,20,9,17,39,43.6,22,16,4,12,12,50,7,0,"https://fbref.com/en/players/3708e9fa/Aleksandr-Golovin"
2025,"Monaco","Ligue 1","George Ilenikhena","FRA","FW","18-284",2006,8,4,2,0,3,1,1,2,50,1,0,0,0,2,6,0,0,"https://fbref.com/en/players/78c3ad07/George-Ilenikhena"
2025,"Monaco","Ligue 1","Ismail Jakobs","SEN","DF","25-283",1999,2,5,5,3,0,2,3,5,60,2,0,0,0,2,7,6,0,"https://fbref.com/en/players/a0415710/Ismail-Jakobs"
2025,"Monaco","Ligue 1","Thilo Kehrer","GER","DF","28-248",1996,26.5,37,23,26,11,0,22,38,57.9,16,18,10,8,36,73,113,1,"https://fbref.com/en/players/51dbeea9/Thilo-Kehrer"
2025,"Monaco","Ligue 1","Philipp Köhn","SUI","GK","27-055",1998,19,0,0,0,0,0,0,1,0,1,0,0,0,0,0,11,2,"https://fbref.com/en/players/ff74841d/Philipp-Kohn"
2025,"Monaco","Ligue 1","Soungoutou Magassa","FRA","MF","21-231",2003,11.4,47,25,14,27,6,25,46,54.3,21,16,3,13,21,68,19,1,"https://fbref.com/en/players/dfc5d4fa/Soungoutou-Magassa"
2025,"Monaco","Ligue 1","Radosław Majecki","POL","GK","25-192",1999,15,0,0,0,0,0,0,2,0,2,0,0,0,0,0,8,1,"https://fbref.com/en/players/20de219a/Radoslaw-Majecki"
2025,"Monaco","Ligue 1","Eliot Matazo","BEL","MF","23-101",2002,0.8,3,2,0,3,0,0,0,NA,0,0,0,0,1,4,2,0,"https://fbref.com/en/players/15944afd/Eliot-Matazo"
2025,"Monaco","Ligue 1","Christian Mawissa","FRA","DF","20-039",2005,16.7,42,29,27,13,2,26,44,59.1,18,25,6,19,26,68,48,1,"https://fbref.com/en/players/2c70d915/Christian-Mawissa"
2025,"Monaco","Ligue 1","Lucas Michal","FRA","FW,MF","19-340",2005,1.3,5,3,3,2,0,2,4,50,2,2,0,2,1,6,2,0,"https://fbref.com/en/players/0c7b1c91/Lucas-Michal"
2025,"Monaco","Ligue 1","Takumi Minamino","JPN","MF,FW","30-131",1995,24.8,33,19,7,14,12,15,42,35.7,27,26,1,25,10,43,20,0,"https://fbref.com/en/players/f833a830/Takumi-Minamino"
2025,"Monaco","Ligue 1","Almoatasem Al Musrati","LBY","MF","29-051",1996,4.3,14,11,5,8,1,7,11,63.6,4,3,1,2,5,19,9,0,"https://fbref.com/en/players/cd6a1a59/Almoatasem-Al-Musrati"
2025,"Monaco","Ligue 1","Kassoum Ouattara","FRA","DF,FW","20-225",2004,4.3,9,7,5,4,0,4,14,28.6,10,6,0,6,5,14,2,1,"https://fbref.com/en/players/6620c21a/Kassoum-Ouattara"
2025,"Monaco","Ligue 1","Mohammed Salisu","GHA","DF","26-040",1999,11.4,28,18,16,11,1,13,16,81.3,3,10,8,2,16,44,54,2,"https://fbref.com/en/players/0b33f6ad/Mohammed-Salisu"
2025,"Monaco","Ligue 1","Caio Henrique Oliveira Silva","BRA","DF","27-300",1997,21.4,37,26,16,19,2,23,44,52.3,21,26,8,18,22,59,59,0,"https://fbref.com/en/players/30af8b93/Caio-Henrique-Oliveira-Silva"
2025,"Monaco","Ligue 1","Wilfried Singo","CIV","DF","24-153",2000,23.3,37,23,24,10,3,20,28,71.4,8,17,9,8,43,80,110,2,"https://fbref.com/en/players/8b609c34/Wilfried-Singo"
2025,"Monaco","Ligue 1","Jordan Teze","NED","DF","25-239",1999,6.3,18,9,8,9,1,7,16,43.8,9,12,1,11,6,24,15,0,"https://fbref.com/en/players/82e9b1bb/Jordan-Teze"
2025,"Monaco","Ligue 1","Vanderson","BRA","DF","23-340",2001,22.9,76,48,37,30,9,45,64,70.3,19,43,6,37,39,115,65,2,"https://fbref.com/en/players/ee45fd85/Vanderson"
2025,"Monaco","Ligue 1","Denis Zakaria","SUI","MF","28-188",1996,23.8,41,26,15,19,7,24,33,72.7,9,31,8,23,34,75,39,1,"https://fbref.com/en/players/384d58d9/Denis-Zakaria"
2025,"Montpellier","Ligue 1","Akor Adams","NGA","FW","25-118",2000,11.9,4,3,1,2,1,3,4,75,1,2,1,1,1,5,5,1,"https://fbref.com/en/players/2ccd39ed/Akor-Adams"
2025,"Montpellier","Ligue 1","Gabriel Bares","SUI","MF,DF","24-271",2000,0.6,2,2,2,0,0,1,2,50,1,0,0,0,1,3,3,0,"https://fbref.com/en/players/5475a510/Gabriel-Bares"
2025,"Montpellier","Ligue 1","Dimitry Bertaud","COD","GK","26-355",1998,4,0,0,0,0,0,0,0,NA,0,0,0,0,0,0,2,0,"https://fbref.com/en/players/380a15e2/Dimitry-Bertaud"
2025,"Montpellier","Ligue 1","Simon Cara","FRA","MF,FW","19-361",2005,0.1,0,0,0,0,0,0,0,NA,0,0,0,0,0,0,0,0,"https://fbref.com/en/players/3545e643/Simon-Cara"
2025,"Montpellier","Ligue 1","Théo Chennahi","FRA","DF","20-110",2005,2,6,3,3,3,0,4,7,57.1,3,3,0,3,2,8,6,0,"https://fbref.com/en/players/5a5b785e/Theo-Chennahi"
2025,"Montpellier","Ligue 1","Joris Chotard","FRA","MF","23-245",2001,21,39,27,17,20,2,20,46,43.5,26,28,10,18,19,58,52,1,"https://fbref.com/en/players/7909ffa4/Joris-Chotard"
2025,"Montpellier","Ligue 1","Tanguy Coulibaly","FRA","FW,MF","24-098",2001,16.5,32,24,13,15,4,14,33,42.4,19,18,2,16,11,43,3,1,"https://fbref.com/en/players/05ba9d7c/Tanguy-Coulibaly"
2025,"Montpellier","Ligue 1","Andy Delort","ALG","FW","33-230",1991,6.7,4,3,1,2,1,1,2,50,1,3,1,2,0,4,3,0,"https://fbref.com/en/players/d33c706e/Andy-Delort"
2025,"Montpellier","Ligue 1","Stefan Džodić","SRB","DF,MF","20-073",2005,2.7,8,5,3,5,0,5,8,62.5,3,5,4,1,5,13,10,1,"https://fbref.com/en/players/38ef169e/Stefan-Dzodic"
2025,"Montpellier","Ligue 1","Khalil Fayad","FRA","MF,FW","20-352",2004,11.4,31,16,12,17,2,15,28,53.6,13,18,1,17,10,41,15,1,"https://fbref.com/en/players/faf00ab8/Khalil-Fayad"
2025,"Montpellier","Ligue 1","Jordan Ferri","FRA","MF","33-076",1992,19.7,42,23,18,22,2,18,44,40.9,26,20,3,17,9,51,20,0,"https://fbref.com/en/players/375622c5/Jordan-Ferri"
2025,"Montpellier","Ligue 1","Axel Gueguin","FRA","FW","20-064",2005,0.3,1,1,0,1,0,1,1,100,0,0,0,0,0,1,0,0,"https://fbref.com/en/players/f6857b4f/Axel-Gueguin"
2025,"Montpellier","Ligue 1","Yanis Issoufou","FRA","MF,FW","18-211",2006,0.9,6,4,4,1,1,3,5,60,2,1,0,1,0,6,1,0,"https://fbref.com/en/players/5d004b30/Yanis-Issoufou"
2025,"Montpellier","Ligue 1","Wahbi Khazri","TUN","FW,MF","34-108",1991,12.4,25,18,5,16,4,8,21,38.1,13,13,1,12,5,30,7,0,"https://fbref.com/en/players/2677a1de/Wahbi-Khazri"
2025,"Montpellier","Ligue 1","Boubakar Kouyaté","MLI","DF","28-042",1997,8.4,22,17,16,6,0,11,19,57.9,8,17,11,6,12,34,54,0,"https://fbref.com/en/players/562a4799/Boubakar-Kouyate"
2025,"Montpellier","Ligue 1","Benjamin Lecomte","FRA","GK","34-031",1991,30,0,0,0,0,0,0,0,NA,0,0,0,0,0,0,18,2,"https://fbref.com/en/players/2fa2a875/Benjamin-Lecomte"
2025,"Montpellier","Ligue 1","Othmane Maamma","MAR","FW,MF","19-233",2005,4,3,1,2,1,0,1,4,25,3,4,0,4,1,4,2,1,"https://fbref.com/en/players/5bdb4a7b/Othmane-Maamma"
2025,"Montpellier","Ligue 1","Nikola Maksimović","SRB","DF","33-183",1991,6.5,9,5,6,3,0,6,7,85.7,1,5,4,1,6,15,30,1,"https://fbref.com/en/players/16b9d5cf/Nikola-Maksimovic"
2025,"Montpellier","Ligue 1","Bamo Meïté","CIV","DF","23-175",2001,4.7,5,3,2,1,2,1,2,50,1,3,3,0,4,9,14,3,"https://fbref.com/en/players/04ac78d2/Bamo-Meite"
2025,"Montpellier","Ligue 1","Lucas Mincarelli","FRA","DF","21-142",2004,7.9,17,10,6,9,2,6,13,46.2,7,8,5,3,9,26,27,0,"https://fbref.com/en/players/02b3733e/Lucas-Mincarelli"
2025,"Montpellier","Ligue 1","Yael Mouanga","FRA","DF","19-308",2005,10.5,14,8,9,3,2,7,9,77.8,2,16,8,8,10,24,50,0,"https://fbref.com/en/players/153e48e0/Yael-Mouanga"
2025,"Montpellier","Ligue 1","Junior Ndiaye","FRA","FW","20-059",2005,4.9,3,2,2,1,0,1,4,25,3,2,1,1,0,3,2,0,"https://fbref.com/en/players/03412e45/Junior-Ndiaye"
2025,"Montpellier","Ligue 1","Wilfried Ndollo","CMR","DF","19-318",2005,4.5,6,5,4,1,1,4,8,50,4,9,1,8,7,13,11,0,"https://fbref.com/en/players/f2b7d401/Wilfried-Ndollo"
2025,"Montpellier","Ligue 1","Arnaud Nordin","FRA","FW","26-344",1998,13,24,15,6,16,2,11,21,52.4,10,12,0,12,5,29,7,0,"https://fbref.com/en/players/7b9a9e25/Arnaud-Nordin"
2025,"Montpellier","Ligue 1","Rabby Nzingoula","CGO","MF","19-183",2005,18.8,64,42,26,31,7,27,58,46.6,31,27,5,22,29,93,23,0,"https://fbref.com/en/players/627c7a3d/Rabby-Nzingoula"
2025,"Montpellier","Ligue 1","Becir Omeragic","SUI","DF","23-127",2002,20,32,16,19,12,1,16,21,76.2,5,32,21,11,13,45,78,0,"https://fbref.com/en/players/c284d6fb/Becir-Omeragic"
2025,"Montpellier","Ligue 1","Nicolas Pays","FRA","FW,MF","21-293",2003,5,13,6,3,4,6,4,8,50,4,1,0,1,4,17,2,0,"https://fbref.com/en/players/b9f2c759/Nicolas-Pays"
2025,"Montpellier","Ligue 1","Falaye Sacko","MLI","DF","30-026",1995,13.7,14,8,9,4,1,9,19,47.4,10,17,7,10,13,27,21,0,"https://fbref.com/en/players/6388e356/Falaye-Sacko"
2025,"Montpellier","Ligue 1","Modibo Sagnan","MLI","DF","26-043",1999,23.8,57,35,38,16,3,26,44,59.1,18,24,13,11,29,86,110,5,"https://fbref.com/en/players/76d679c7/Modibo-Sagnan"
2025,"Montpellier","Ligue 1","Théo Sainte-Luce","FRA","DF","26-219",1998,11.3,24,11,16,4,4,16,33,48.5,17,16,4,12,12,36,33,1,"https://fbref.com/en/players/93c942fb/Theo-Sainte-Luce"
2025,"Montpellier","Ligue 1","Téji Savanier","FRA","MF","33-156",1991,26.3,29,25,7,16,6,18,43,41.9,25,16,1,15,15,44,21,4,"https://fbref.com/en/players/6bde367b/Teji-Savanier"
2025,"Montpellier","Ligue 1","Issiaga Sylla","GUI","DF","31-146",1994,12.8,25,10,17,7,1,15,29,51.7,14,13,4,9,10,35,34,1,"https://fbref.com/en/players/b99bec05/Issiaga-Sylla"
2025,"Montpellier","Ligue 1","Musa Al-Taamari","JOR","FW,MF","27-351",1997,12.4,14,10,4,5,5,8,15,53.3,7,2,0,2,3,17,3,2,"https://fbref.com/en/players/f15f8b2b/Musa-Al-Taamari"
2025,"Montpellier","Ligue 1","Enzo Tchato","CMR","DF","22-185",2002,21.1,48,26,26,18,4,26,44,59.1,18,30,10,20,22,70,59,0,"https://fbref.com/en/players/7f783431/Enzo-Tchato"
2025,"Montpellier","Ligue 1","Birama Touré","MLI","MF,DF","32-355",1992,3.3,8,5,5,2,1,4,6,66.7,2,3,2,1,6,14,7,0,"https://fbref.com/en/players/a4b798a9/Birama-Toure"
2025,"Monza","Serie A","Jean-Daniel Akpa-Akpro","CIV","MF","32-228",1992,10.7,30,18,15,14,1,9,21,42.9,12,19,6,13,13,43,16,1,"https://fbref.com/en/players/fdf4b948/Jean-Daniel-Akpa-Akpro"
2025,"Monza","Serie A","Keita Baldé","SEN","FW","30-080",1995,7.1,1,1,0,1,0,1,2,50,1,4,0,4,2,3,0,0,"https://fbref.com/en/players/509a4ccb/Keita-Balde"
2025,"Monza","Serie A","Alessandro Bianco","ITA","MF","22-238",2002,28.9,51,28,26,17,8,27,41,65.9,14,40,14,26,22,73,53,4,"https://fbref.com/en/players/d65cf468/Alessandro-Bianco"
2025,"Monza","Serie A","Samuele Birindelli","ITA","DF,MF","25-312",1999,16.3,22,15,13,4,5,6,14,42.9,8,15,2,13,10,32,34,2,"https://fbref.com/en/players/204ac005/Samuele-Birindelli"
2025,"Monza","Serie A","Warren Bondo","FRA","MF","21-254",2003,18,35,24,19,12,4,13,19,68.4,6,16,6,10,5,40,8,4,"https://fbref.com/en/players/0def2376/Warren-Bondo"
2025,"Monza","Serie A","Arvid Brorsson","SWE","DF","26-019",1999,4,4,3,2,2,0,2,5,40,3,9,8,1,2,6,35,1,"https://fbref.com/en/players/9f2989f4/Arvid-Brorsson"
2025,"Monza","Serie A","Luca Caldirola","ITA","DF","34-115",1991,9.7,11,7,8,3,0,4,7,57.1,3,9,6,3,11,22,43,1,"https://fbref.com/en/players/226008f1/Luca-Caldirola"
2025,"Monza","Serie A","Gianluca Caprari","ITA","MF,FW","31-301",1993,18.3,19,11,8,8,3,7,14,50,7,14,0,14,8,27,2,1,"https://fbref.com/en/players/54e53b7e/Gianluca-Caprari"
2025,"Monza","Serie A","Andrea Carboni","ITA","DF","24-112",2001,24.3,60,35,39,17,4,35,53,66,18,31,16,15,27,87,106,4,"https://fbref.com/en/players/f7e2af2c/Andrea-Carboni"
2025,"Monza","Serie A","Gaetano Castrovilli","ITA","MF","28-099",1997,6.6,12,7,10,2,0,4,11,36.4,7,8,2,6,2,14,9,0,"https://fbref.com/en/players/0728bebe/Gaetano-Castrovilli"
2025,"Monza","Serie A","Patrick Ciurria","ITA","MF,DF","30-107",1995,12.3,22,14,11,7,4,4,11,36.4,7,13,3,10,6,28,22,0,"https://fbref.com/en/players/5de3866c/Patrick-Ciurria"
2025,"Monza","Serie A","Danilo D'Ambrosio","ITA","DF","36-260",1988,12.2,28,15,17,10,1,14,23,60.9,9,12,8,4,15,43,36,2,"https://fbref.com/en/players/44eb9093/Danilo-DAmbrosio"
2025,"Monza","Serie A","Omari Forson","ENG","MF,FW","20-311",2004,2.5,3,3,1,2,0,1,3,33.3,2,3,0,3,1,4,1,0,"https://fbref.com/en/players/1b9728b0/Omari-Forson"
2025,"Monza","Serie A","Roberto Gagliardini","ITA","MF,DF","31-050",1994,2,3,2,1,2,0,1,4,25,3,1,0,1,2,5,4,0,"https://fbref.com/en/players/ce30bfc8/Roberto-Gagliardini"
2025,"Monza","Serie A","Silvère Ganvoula M'Boussy","CGO","FW","28-339",1996,3.6,0,0,0,0,0,0,1,0,1,1,0,1,1,1,5,0,"https://fbref.com/en/players/6c731625/Silvere-Ganvoula-MBoussy"
2025,"Monza","Serie A","Armando Izzo","ITA","DF","33-086",1992,27.1,40,15,30,9,1,18,36,50,18,38,28,10,45,85,101,0,"https://fbref.com/en/players/89976232/Armando-Izzo"
2025,"Monza","Serie A","Giorgos Kyriakopoulos","GRE","DF","29-111",1996,31.6,43,26,20,18,5,30,61,49.2,31,28,10,18,23,66,79,0,"https://fbref.com/en/players/0a483542/Giorgos-Kyriakopoulos"
2025,"Monza","Serie A","Stefan Lekovic","SRB","DF","21-138",2004,4.1,9,4,6,2,1,5,13,38.5,8,4,4,0,7,16,5,0,"https://fbref.com/en/players/d633fd46/Stefan-Lekovic"
2025,"Monza","Serie A","Daniel Maldini","ITA","MF,FW","23-228",2001,14.5,14,6,5,9,0,6,13,46.2,7,8,2,6,4,18,12,2,"https://fbref.com/en/players/801831fe/Daniel-Maldini"
2025,"Monza","Serie A","Pablo Marí","ESP","DF","31-269",1993,18.1,26,15,14,12,0,11,21,52.4,10,24,21,3,37,63,85,2,"https://fbref.com/en/players/aa54ec6f/Pablo-Mari"
2025,"Monza","Serie A","Mirko Marić","CRO","FW,MF","30-011",1995,1.2,1,0,1,0,0,1,2,50,1,1,1,0,1,2,1,0,"https://fbref.com/en/players/78338347/Mirko-Maric"
2025,"Monza","Serie A","Kevin Martins","ITA","MF,DF","20-116",2005,2,5,4,3,2,0,3,6,50,3,1,0,1,1,6,4,1,"https://fbref.com/en/players/c1451401/Kevin-Martins"
2025,"Monza","Serie A","Andrea Mazza","ITA","GK","21-069",2004,0.1,0,0,0,0,0,0,0,NA,0,0,0,0,0,0,0,0,"https://fbref.com/en/players/f93a544c/Andrea-Mazza"
2025,"Monza","Serie A","Dany Mota","POR","FW,MF","27-025",1998,23.4,13,3,2,3,8,4,8,50,4,18,1,17,9,22,27,3,"https://fbref.com/en/players/efc9e31f/Dany-Mota"
2025,"Monza","Serie A","Tomás Palacios","ARG","DF","22-029",2003,5,11,5,9,2,0,9,13,69.2,4,7,2,5,8,19,17,2,"https://fbref.com/en/players/404101f9/Tomas-Palacios"
2025,"Monza","Serie A","Pedro Pereira","POR","DF","27-125",1998,29.6,53,32,30,18,5,35,55,63.6,20,26,12,14,21,74,85,5,"https://fbref.com/en/players/c77be0cf/Pedro-Pereira"
2025,"Monza","Serie A","Matteo Pessina","ITA","MF","28-036",1997,9.5,15,4,3,11,1,9,14,64.3,5,6,0,6,12,27,7,0,"https://fbref.com/en/players/780e3631/Matteo-Pessina"
2025,"Monza","Serie A","Andrea Petagna","ITA","FW","29-331",1995,3.7,2,1,0,1,1,1,2,50,1,0,0,0,1,3,2,0,"https://fbref.com/en/players/03f946ed/Andrea-Petagna"
2025,"Monza","Serie A","Semuel Pizzignacco","ITA","GK","23-268",2001,8.2,0,0,0,0,0,0,1,0,1,0,0,0,0,0,6,0,"https://fbref.com/en/players/4f537cf7/Semuel-Pizzignacco"
2025,"Monza","Serie A","Stefano Sensi","ITA","MF","29-295",1995,3,8,5,4,4,0,5,6,83.3,1,4,2,2,3,11,3,1,"https://fbref.com/en/players/b70bde8f/Stefano-Sensi"
2025,"Monza","Serie A","Stefano Turati","ITA","GK","23-264",2001,29.7,0,0,0,0,0,0,1,0,1,0,0,0,0,0,21,2,"https://fbref.com/en/players/bf168004/Stefano-Turati"
2025,"Monza","Serie A","Kacper Urbanski","POL","MF","20-262",2004,5.6,5,3,1,2,2,4,7,57.1,3,7,2,5,2,7,9,0,"https://fbref.com/en/players/2d9d9e42/Kacper-Urbanski"
2025,"Monza","Serie A","Mattia Valoti","ITA","MF","31-263",1993,0.4,3,3,3,0,0,0,2,0,2,2,0,2,0,3,2,0,"https://fbref.com/en/players/c414df9d/Mattia-Valoti"
2025,"Monza","Serie A","Samuele Vignato","ITA","MF","21-092",2004,5.2,6,3,0,4,2,3,7,42.9,4,1,0,1,0,6,6,0,"https://fbref.com/en/players/a14d0ab0/Samuele-Vignato"
2025,"Monza","Serie A","Kevin Zeroli","ITA","MF","20-136",2005,4.4,6,2,3,3,0,0,1,0,1,6,1,5,2,8,11,0,"https://fbref.com/en/players/7d6d4395/Kevin-Zeroli"
2025,"Monza","Serie A","Milan Đurić","BIH","FW","35-005",1990,14.1,1,1,0,1,0,0,3,0,3,6,0,6,2,3,17,0,"https://fbref.com/en/players/405f6586/Milan-Djuric"
2025,"Nantes","Ligue 1","Matthis Abline","FRA","FW","22-060",2003,30.8,11,5,2,4,5,3,9,33.3,6,15,1,14,4,15,36,1,"https://fbref.com/en/players/0e46fa2f/Matthis-Abline"
2025,"Nantes","Ligue 1","Kelvin Amian","FRA","DF","27-108",1998,24.1,55,31,40,14,1,29,35,82.9,6,18,11,7,13,68,85,0,"https://fbref.com/en/players/bcc81786/Kelvin-Amian"
2025,"Nantes","Ligue 1","Dehmaine Assoumani","FRA","MF,FW","20-040",2005,1.1,6,3,0,4,2,4,5,80,1,1,0,1,1,7,4,0,"https://fbref.com/en/players/fb32896c/Dehmaine-Assoumani"
2025,"Nantes","Ligue 1","Patrik Carlgren","SWE","GK","33-139",1992,4.6,0,0,0,0,0,0,0,NA,0,0,0,0,0,0,0,0,"https://fbref.com/en/players/168c50c5/Patrik-Carlgren"
2025,"Nantes","Ligue 1","Jean-Charles Castelletto","CMR","DF,MF","30-121",1995,29.1,34,17,17,15,2,17,27,63,10,27,18,9,25,59,151,0,"https://fbref.com/en/players/e0f3a1f6/Jean-Charles-Castelletto"
2025,"Nantes","Ligue 1","Fabien Centonze","FRA","DF","29-131",1996,2.9,8,4,5,2,1,4,6,66.7,2,4,1,3,2,10,17,0,"https://fbref.com/en/players/3c6bbbab/Fabien-Centonze"
2025,"Nantes","Ligue 1","Pedro Chirivella","ESP","MF","28-004",1997,26.1,44,29,23,16,5,19,42,45.2,23,25,4,21,19,63,45,0,"https://fbref.com/en/players/68a26d51/Pedro-Chirivella"
2025,"Nantes","Ligue 1","Marcus Coco","FRA","DF","28-337",1996,10.6,27,21,15,9,3,16,31,51.6,15,16,5,11,11,38,46,0,"https://fbref.com/en/players/3010aefb/Marcus-Coco"
2025,"Nantes","Ligue 1","Francis Coquelin","FRA","MF","34-014",1991,2.5,9,5,5,3,1,3,4,75,1,3,1,2,6,15,3,0,"https://fbref.com/en/players/a6951bf8/Francis-Coquelin"
2025,"Nantes","Ligue 1","Nicolas Cozza","FRA","DF,MF","26-139",1999,22.8,59,41,35,18,6,31,47,66,16,25,10,15,25,84,69,0,"https://fbref.com/en/players/8f325097/Nicolas-Cozza"
2025,"Nantes","Ligue 1","Sékou Doucoure","FRA","DF","20-031",2005,0.1,0,0,0,0,0,0,0,NA,0,0,0,0,0,0,3,0,"https://fbref.com/en/players/135ebd39/Sekou-Doucoure"
2025,"Nantes","Ligue 1","Douglas","BRA","MF","28-134",1997,25.6,69,42,29,31,9,26,44,59.1,18,51,11,40,32,101,47,0,"https://fbref.com/en/players/301c287b/Douglas"
2025,"Nantes","Ligue 1","Jean-Kevin Duverne","HAI","DF","27-319",1997,6,21,12,13,4,4,15,27,55.6,12,10,3,7,8,29,23,0,"https://fbref.com/en/players/0cbc8baa/Jean-Kevin-Duverne"
2025,"Nantes","Ligue 1","Meschak Elia","COD","FW","27-294",1997,1.9,7,5,3,2,2,1,1,100,0,3,0,3,0,7,2,0,"https://fbref.com/en/players/5d51b074/Meschak-Elia"
2025,"Nantes","Ligue 1","Ignatius Ganago","CMR","FW,MF","26-100",1999,2.7,1,1,0,1,0,1,2,50,1,3,1,2,4,5,2,0,"https://fbref.com/en/players/23c63b7f/Ignatius-Ganago"
2025,"Nantes","Ligue 1","Jean-Philippe Gbamin","CIV","MF","29-244",1995,2.4,2,1,0,2,0,1,4,25,3,5,2,3,3,5,2,0,"https://fbref.com/en/players/6bd603db/Jean-Philippe-Gbamin"
2025,"Nantes","Ligue 1","Bahereba Guirassy","FRA","FW,MF","18-271",2006,3.9,12,8,6,3,3,7,13,53.8,6,10,0,10,1,13,4,0,"https://fbref.com/en/players/a08bb82c/Bahereba-Guirassy"
2025,"Nantes","Ligue 1","Tino Kadewere","ZIM","MF,FW","29-142",1996,5.7,14,8,5,3,6,6,13,46.2,7,3,0,3,6,20,8,0,"https://fbref.com/en/players/7d08063d/Tino-Kadewere"
2025,"Nantes","Ligue 1","Alban Lafont","FRA","GK","26-124",1999,12,1,1,1,0,0,1,1,100,0,2,0,2,0,1,8,1,"https://fbref.com/en/players/4e7db402/Alban-Lafont"
2025,"Nantes","Ligue 1","Johann Lepenant","FRA","MF","22-217",2002,22.8,68,33,30,27,11,32,71,45.1,39,35,3,32,18,86,25,0,"https://fbref.com/en/players/1e52971c/Johann-Lepenant"
2025,"Nantes","Ligue 1","Louis Leroux","FRA","MF,DF","19-124",2006,9.1,25,18,10,12,3,16,22,72.7,6,22,2,20,8,33,19,1,"https://fbref.com/en/players/88972aa9/Louis-Leroux"
2025,"Nantes","Ligue 1","Anthony Lopes","POR","GK","34-238",1990,17.4,1,0,1,0,0,1,1,100,0,0,0,0,1,2,7,1,"https://fbref.com/en/players/f00de885/Anthony-Lopes"
2025,"Nantes","Ligue 1","Mostafa Mohamed","EGY","FW","27-180",1997,13.9,18,9,6,8,4,4,12,33.3,8,10,2,8,10,28,27,0,"https://fbref.com/en/players/595e6f3e/Mostafa-Mohamed"
2025,"Nantes","Ligue 1","Florent Mollet","FRA","MF,FW","33-189",1991,2.7,2,2,1,1,0,1,1,100,0,2,0,2,1,3,4,0,"https://fbref.com/en/players/7e82a78f/Florent-Mollet"
2025,"Nantes","Ligue 1","Plamedi Nsingi","","MF","24-161",2000,0.2,1,0,1,0,0,0,1,0,1,0,0,0,0,1,0,0,"https://fbref.com/en/players/ab90a99b/Plamedi-Nsingi"
2025,"Nantes","Ligue 1","Nicolas Pallois","FRA","DF","37-250",1987,22.4,61,27,44,13,4,37,63,58.7,26,48,18,30,28,89,164,3,"https://fbref.com/en/players/779847d6/Nicolas-Pallois"
2025,"Nantes","Ligue 1","Moses Simon","NGA","FW,MF","29-319",1995,29,20,14,4,7,9,7,22,31.8,15,11,0,11,12,32,13,0,"https://fbref.com/en/players/5f3eaaf5/Moses-Simon"
2025,"Nantes","Ligue 1","Saidou Sow","GUI","DF","22-327",2002,8.9,17,11,13,4,0,6,10,60,4,19,12,7,13,30,46,1,"https://fbref.com/en/players/f6b94e8d/Saidou-Sow"
2025,"Nantes","Ligue 1","Sorba Thomas","WAL","FW,MF","25-278",1999,14.7,14,6,7,5,2,10,18,55.6,8,12,2,10,9,23,27,1,"https://fbref.com/en/players/8725a42e/Sorba-Thomas"
2025,"Nantes","Ligue 1","Nathan Zeze","FRA","DF","19-343",2005,16.8,38,22,22,16,0,23,33,69.7,10,22,9,13,23,61,120,1,"https://fbref.com/en/players/fb4c5b6e/Nathan-Zeze"
2025,"Napoli","Serie A","Philip Billing","DEN","MF","28-350",1996,2.2,9,6,4,4,1,1,4,25,3,4,1,3,4,13,6,0,"https://fbref.com/en/players/d328a254/Philip-Billing"
2025,"Napoli","Serie A","Alessandro Buongiorno","ITA","DF","25-355",1999,21.4,39,23,26,12,1,24,32,75,8,30,18,12,35,74,73,2,"https://fbref.com/en/players/4ae67f27/Alessandro-Buongiorno"
2025,"Napoli","Serie A","Elia Caprile","ITA","GK","23-275",2001,3.6,0,0,0,0,0,0,0,NA,0,0,0,0,0,0,2,0,"https://fbref.com/en/players/97d7afbd/Elia-Caprile"
2025,"Napoli","Serie A","Walid Cheddira","MAR","FW","27-125",1998,0.1,0,0,0,0,0,0,0,NA,0,0,0,0,0,0,0,0,"https://fbref.com/en/players/0545a08e/Walid-Cheddira"
2025,"Napoli","Serie A","Giovanni Di Lorenzo","ITA","DF","31-296",1993,37,66,44,35,25,6,42,65,64.6,23,19,6,13,31,97,85,1,"https://fbref.com/en/players/230a2fac/Giovanni-Di-Lorenzo"
2025,"Napoli","Serie A","Michael Folorunsho","ITA","FW,MF","27-109",1998,0.4,3,2,0,3,0,2,4,50,2,0,0,0,1,4,1,1,"https://fbref.com/en/players/c391a179/Michael-Folorunsho"
2025,"Napoli","Serie A","Billy Gilmour","SCO","MF","23-350",2001,13.1,24,16,10,9,5,12,20,60,8,6,1,5,9,33,23,0,"https://fbref.com/en/players/df10e27c/Billy-Gilmour"
2025,"Napoli","Serie A","Juan Jesus","BRA","DF","33-351",1991,11.9,25,14,16,9,0,12,20,60,8,15,3,12,9,34,42,0,"https://fbref.com/en/players/79083382/Juan-Jesus"
2025,"Napoli","Serie A","Khvicha Kvaratskhelia","GEO","FW,MF","24-104",2001,13.1,15,9,4,10,1,4,15,26.7,11,13,0,13,4,19,7,0,"https://fbref.com/en/players/dea88efd/Khvicha-Kvaratskhelia"
2025,"Napoli","Serie A","Stanislav Lobotka","SVK","MF","30-183",1994,29.3,47,30,16,21,10,19,31,61.3,12,29,11,18,21,68,57,1,"https://fbref.com/en/players/e1cbb531/Stanislav-Lobotka"
2025,"Napoli","Serie A","Romelu Lukaku","BEL","FW","32-014",1993,31.6,4,2,0,2,2,1,4,25,3,7,2,5,1,5,17,0,"https://fbref.com/en/players/5eae500a/Romelu-Lukaku"
2025,"Napoli","Serie A","Rafa Marín","ESP","DF","23-008",2002,1.6,1,0,1,0,0,1,2,50,1,1,1,0,1,2,4,0,"https://fbref.com/en/players/3239a8ed/Rafa-Marin"
2025,"Napoli","Serie A","Pasquale Mazzocchi","ITA","DF,FW","29-304",1995,7.8,15,7,7,5,3,8,15,53.3,7,5,2,3,5,20,25,0,"https://fbref.com/en/players/eb0ec070/Pasquale-Mazzocchi"
2025,"Napoli","Serie A","Scott McTominay","SCO","MF","28-170",1996,32.6,43,25,12,27,4,18,36,50,18,22,5,17,24,67,51,0,"https://fbref.com/en/players/d93c2511/Scott-McTominay"
2025,"Napoli","Serie A","Alex Meret","ITA","GK","28-066",1997,33.4,0,0,0,0,0,0,0,NA,0,1,0,1,0,0,16,0,"https://fbref.com/en/players/9413b19f/Alex-Meret"
2025,"Napoli","Serie A","David Neres","BRA","FW","28-085",1997,14.3,21,11,10,4,7,10,15,66.7,5,7,0,7,7,28,4,0,"https://fbref.com/en/players/4f1e6a0b/David-Neres"
2025,"Napoli","Serie A","Cyril Ngonge","BEL","FW","25-001",2000,2.4,8,5,4,4,0,4,7,57.1,3,3,0,3,2,10,4,0,"https://fbref.com/en/players/2b8360f1/Cyril-Ngonge"
2025,"Napoli","Serie A","Noah Okafor","SUI","FW,MF","25-003",2000,0.4,3,2,3,0,0,2,2,100,0,0,0,0,0,3,1,0,"https://fbref.com/en/players/ca607d59/Noah-Okafor"
2025,"Napoli","Serie A","Mathías Olivera","URU","DF","27-208",1997,26.3,63,35,31,25,7,32,53,60.4,21,36,12,24,28,91,74,1,"https://fbref.com/en/players/41c12f75/Mathias-Olivera"
2025,"Napoli","Serie A","Matteo Politano","ITA","FW,MF","31-297",1993,31.2,29,15,17,11,1,15,43,34.9,28,21,1,20,13,42,50,1,"https://fbref.com/en/players/5e861944/Matteo-Politano"
2025,"Napoli","Serie A","Giacomo Raspadori","ITA","FW,MF","25-098",2000,12.3,18,9,6,10,2,8,12,66.7,4,10,2,8,3,21,13,0,"https://fbref.com/en/players/6e058f06/Giacomo-Raspadori"
2025,"Napoli","Serie A","Amir Rrahmani","KVX","DF","31-092",1994,37.8,39,31,19,19,1,16,25,64,9,43,26,17,27,66,179,2,"https://fbref.com/en/players/4b3e1a38/Amir-Rrahmani"
2025,"Napoli","Serie A","Simone Scuffet","ITA","GK","28-361",1996,1,0,0,0,0,0,0,0,NA,0,0,0,0,0,0,2,0,"https://fbref.com/en/players/41bd99ea/Simone-Scuffet"
2025,"Napoli","Serie A","Giovanni Simeone","ARG","FW","29-326",1995,4.7,2,0,0,1,1,1,6,16.7,5,9,2,7,1,3,6,0,"https://fbref.com/en/players/343c0d52/Giovanni-Simeone"
2025,"Napoli","Serie A","Leonardo Spinazzola","ITA","DF,FW","32-063",1993,16.9,17,10,6,9,2,10,23,43.5,13,12,1,11,9,26,31,1,"https://fbref.com/en/players/3626daea/Leonardo-Spinazzola"
2025,"Napoli","Serie A","Andre-Frank Zambo Anguissa","CMR","MF","29-192",1995,31.7,42,26,8,28,6,15,34,44.1,19,24,6,18,35,77,40,1,"https://fbref.com/en/players/6bb2c084/Andre-Frank-Zambo-Anguissa"
2025,"Napoli","Serie A","Alessio Zerbin","ITA","FW,DF","26-085",1999,0,2,1,2,0,0,1,1,100,0,0,0,0,0,2,0,0,"https://fbref.com/en/players/d19ef4ef/Alessio-Zerbin"
2025,"Newcastle Utd","Premier League","Miguel Almirón","PAR","FW","31-106",1994,1.7,3,2,2,0,1,2,3,66.7,1,2,0,2,0,3,0,0,"https://fbref.com/en/players/862a1c15/Miguel-Almiron"
2025,"Newcastle Utd","Premier League","Harvey Barnes","ENG","FW","27-169",1997,19.5,16,9,4,6,6,3,11,27.3,8,8,2,6,6,22,15,1,"https://fbref.com/en/players/3ea50f67/Harvey-Barnes"
2025,"Newcastle Utd","Premier League","Sven Botman","NED","DF","25-135",2000,4.6,12,9,6,5,1,7,9,77.8,2,5,4,1,5,17,25,1,"https://fbref.com/en/players/ccce7025/Sven-Botman"
2025,"Newcastle Utd","Premier League","Dan Burn","ENG","DF","33-018",1992,37,39,24,22,15,2,20,36,55.6,16,36,26,10,27,66,197,4,"https://fbref.com/en/players/b2d31e83/Dan-Burn"
2025,"Newcastle Utd","Premier League","Martin Dúbravka","SVK","GK","36-132",1989,10,0,0,0,0,0,0,0,NA,0,0,0,0,0,0,3,0,"https://fbref.com/en/players/3a949a25/Martin-Dubravka"
2025,"Newcastle Utd","Premier League","Anthony Gordon","ENG","FW,MF","24-092",2001,27,32,18,9,18,5,12,37,32.4,25,25,2,23,7,39,9,3,"https://fbref.com/en/players/2bd83368/Anthony-Gordon"
2025,"Newcastle Utd","Premier League","Bruno Guimarães","BRA","MF","27-192",1997,36.3,83,47,41,30,12,33,69,47.8,36,36,10,26,29,112,44,5,"https://fbref.com/en/players/82518f62/Bruno-Guimaraes"
2025,"Newcastle Utd","Premier League","Lewis Hall","ENG","DF","20-261",2004,24.3,58,41,28,22,8,40,74,54.1,34,33,18,15,18,76,75,3,"https://fbref.com/en/players/da011f18/Lewis-Hall"
2025,"Newcastle Utd","Premier League","Alexander Isak","SWE","FW","25-248",1999,30.6,12,5,2,3,7,5,15,33.3,10,18,2,16,3,15,17,1,"https://fbref.com/en/players/8e92be30/Alexander-Isak"
2025,"Newcastle Utd","Premier League","Joelinton","BRA","MF,FW","28-286",1996,26.6,57,35,23,23,11,25,44,56.8,19,37,7,30,23,80,47,2,"https://fbref.com/en/players/c17bfb65/Joelinton"
2025,"Newcastle Utd","Premier League","Lloyd Kelly","ENG","DF","26-233",1998,3.4,5,4,4,1,0,1,1,100,0,6,4,2,1,6,17,0,"https://fbref.com/en/players/f31def1e/Lloyd-Kelly"
2025,"Newcastle Utd","Premier League","Emil Krafth","SWE","DF","30-298",1994,3.8,4,2,2,1,1,2,3,66.7,1,5,4,1,2,6,16,0,"https://fbref.com/en/players/77cf6852/Emil-Krafth"
2025,"Newcastle Utd","Premier League","Valentino Livramento","ENG","DF","22-196",2002,31.6,54,36,35,15,4,32,59,54.2,27,37,11,26,23,77,108,1,"https://fbref.com/en/players/afed6722/Valentino-Livramento"
2025,"Newcastle Utd","Premier League","Sean Longstaff","ENG","MF","27-209",1997,8.9,27,16,10,9,8,18,27,66.7,9,17,5,12,7,34,8,0,"https://fbref.com/en/players/a2b105e0/Sean-Longstaff"
2025,"Newcastle Utd","Premier League","Lewis Miley","ENG","MF","19-026",2006,3.5,14,11,5,7,2,7,14,50,7,5,1,4,2,16,5,2,"https://fbref.com/en/players/2c6835e5/Lewis-Miley"
2025,"Newcastle Utd","Premier League","Jacob Murphy","ENG","FW","30-092",1995,26.2,28,19,10,12,6,20,44,45.5,24,31,0,31,13,41,35,1,"https://fbref.com/en/players/de112b84/Jacob-Murphy"
2025,"Newcastle Utd","Premier League","William Osula","DEN","FW","21-296",2003,1.5,2,0,1,0,1,0,2,0,2,0,0,0,4,6,2,0,"https://fbref.com/en/players/7b355808/William-Osula"
2025,"Newcastle Utd","Premier League","Nick Pope","ENG","GK","33-038",1992,28,0,0,0,0,0,0,0,NA,0,1,0,1,1,1,32,5,"https://fbref.com/en/players/4b40d9ca/Nick-Pope"
2025,"Newcastle Utd","Premier League","Fabian Schär","SUI","DF","33-158",1991,32.6,36,21,16,18,2,14,35,40,21,38,25,13,45,81,138,3,"https://fbref.com/en/players/c8aa95da/Fabian-Schar"
2025,"Newcastle Utd","Premier League","Matt Targett","ENG","DF","29-251",1995,0.2,0,0,0,0,0,0,1,0,1,0,0,0,1,1,1,0,"https://fbref.com/en/players/e514ab62/Matt-Targett"
2025,"Newcastle Utd","Premier League","Sandro Tonali","ITA","MF","25-019",2000,29.2,51,32,22,23,6,25,51,49,26,34,11,23,34,85,33,2,"https://fbref.com/en/players/0db169ae/Sandro-Tonali"
2025,"Newcastle Utd","Premier League","Kieran Trippier","ENG","DF","34-250",1990,14.5,38,21,18,14,6,22,36,61.1,14,11,3,8,12,50,49,0,"https://fbref.com/en/players/21512407/Kieran-Trippier"
2025,"Newcastle Utd","Premier League","Joe Willock","ENG","MF,FW","25-280",1999,12.1,30,17,15,12,3,18,31,58.1,13,24,6,18,6,36,7,0,"https://fbref.com/en/players/a3b03921/Joe-Willock"
2025,"Newcastle Utd","Premier League","Callum Wilson","ENG","FW","33-089",1992,4.1,2,2,0,1,1,0,2,0,2,2,0,2,1,3,1,0,"https://fbref.com/en/players/c596fcb0/Callum-Wilson"
2025,"Nice","Ligue 1","Mohamed Abdelmoneim","EGY","DF","26-115",1999,9.5,21,14,12,6,3,13,22,59.1,9,11,5,6,15,36,56,1,"https://fbref.com/en/players/bff15d74/Mohamed-Abdelmoneim"
2025,"Nice","Ligue 1","Ali Abdi","TUN","DF,MF","31-158",1993,15.5,43,25,18,14,11,28,43,65.1,15,20,6,14,20,63,37,0,"https://fbref.com/en/players/ad7cdb35/Ali-Abdi"
2025,"Nice","Ligue 1","Mohamed Ali Cho","FRA","FW,MF","21-128",2004,18,13,9,4,5,4,4,12,33.3,8,17,1,16,5,18,8,0,"https://fbref.com/en/players/f8405304/Mohamed-Ali-Cho"
2025,"Nice","Ligue 1","Melvin Bard","FRA","DF,MF","24-202",2000,21.5,53,36,35,13,5,24,42,57.1,18,38,13,25,29,82,60,3,"https://fbref.com/en/players/1ddbc7ca/Melvin-Bard"
2025,"Nice","Ligue 1","Jeremie Boga","CIV","MF,FW","28-144",1997,11.7,10,5,2,5,3,4,8,50,4,13,0,13,3,13,2,1,"https://fbref.com/en/players/fe012aca/Jeremie-Boga"
2025,"Nice","Ligue 1","Moïse Bombito","CAN","DF","25-058",2000,24.4,37,25,22,12,3,24,35,68.6,11,35,19,16,18,55,121,7,"https://fbref.com/en/players/c2f23fc8/Moise-Bombito"
2025,"Nice","Ligue 1","Badredine Bouanani","ALG","MF,FW","20-170",2004,12.2,11,4,4,4,3,6,18,33.3,12,16,3,13,11,22,4,0,"https://fbref.com/en/players/0400dd2f/Badredine-Bouanani"
2025,"Nice","Ligue 1","Hicham Boudaoui","ALG","MF","25-246",1999,27.1,76,52,28,37,11,31,53,58.5,22,40,11,29,22,98,45,1,"https://fbref.com/en/players/f9d5908e/Hicham-Boudaoui"
2025,"Nice","Ligue 1","Bilal Brahimi","ALG","MF","25-074",2000,0.8,0,0,0,0,0,0,0,NA,0,1,0,1,0,0,2,0,"https://fbref.com/en/players/02bcaf8e/Bilal-Brahimi"
2025,"Nice","Ligue 1","Marcin Bułka","POL","GK","25-235",1999,34,0,0,0,0,0,0,1,0,1,0,0,0,0,0,16,6,"https://fbref.com/en/players/db87a2c4/Marcin-Bulka"
2025,"Nice","Ligue 1","Issiaga Camara","GUI","MF","20-114",2005,0.2,2,1,0,2,0,0,1,0,1,0,0,0,3,5,0,0,"https://fbref.com/en/players/9a34200f/Issiaga-Camara"
2025,"Nice","Ligue 1","Jonathan Clauss","FRA","DF,MF","32-244",1992,25.6,52,35,27,19,6,28,56,50,28,25,2,23,48,100,68,3,"https://fbref.com/en/players/5219ab4a/Jonathan-Clauss"
2025,"Nice","Ligue 1","Dante","BRA","DF","41-221",1983,21.8,32,15,17,13,2,15,29,51.7,14,29,14,15,34,66,74,1,"https://fbref.com/en/players/fd2bc67d/Dante"
2025,"Nice","Ligue 1","Sofiane Diop","FRA","MF,FW","24-352",2000,11.8,23,16,16,3,4,9,22,40.9,13,19,2,17,17,40,7,1,"https://fbref.com/en/players/19053e31/Sofiane-Diop"
2025,"Nice","Ligue 1","Amidou Doumbouya","FRA","DF","17-295",2007,0.5,1,1,0,0,1,1,1,100,0,3,1,2,1,2,1,0,"https://fbref.com/en/players/c4d2da61/Amidou-Doumbouya"
2025,"Nice","Ligue 1","Evann Guessand","CIV","FW,MF","23-330",2001,28.5,44,29,12,15,17,6,14,42.9,8,27,3,24,15,59,16,0,"https://fbref.com/en/players/b73f17f8/Evann-Guessand"
2025,"Nice","Ligue 1","Rareş Ilie","ROU","MF","22-038",2003,0.1,1,1,1,0,0,1,1,100,0,0,0,0,0,1,0,0,"https://fbref.com/en/players/c9f49454/Rares-Ilie"
2025,"Nice","Ligue 1","Gaëtan Laborde","FRA","FW","31-024",1994,20.3,19,13,9,8,2,9,22,40.9,13,16,4,12,6,25,20,0,"https://fbref.com/en/players/7cdda3bf/Gaetan-Laborde"
2025,"Nice","Ligue 1","Jordan Lotomba","SUI","MF,DF","26-240",1998,0.4,0,0,0,0,0,0,0,NA,0,0,0,0,0,0,1,0,"https://fbref.com/en/players/fc4cf6a7/Jordan-Lotomba"
2025,"Nice","Ligue 1","Tom Louchet","FRA","DF,MF","22-023",2003,8.6,27,17,17,5,5,17,23,73.9,6,12,4,8,18,45,20,0,"https://fbref.com/en/players/f999e9be/Tom-Louchet"
2025,"Nice","Ligue 1","Antoine Mendy","SEN","DF","21-000",2004,9.2,30,21,16,14,0,19,29,65.5,10,9,5,4,8,38,29,1,"https://fbref.com/en/players/3322e296/Antoine-Mendy"
2025,"Nice","Ligue 1","Terem Moffi","NGA","FW","26-002",1999,0.6,0,0,0,0,0,0,0,NA,0,0,0,0,0,0,0,0,"https://fbref.com/en/players/065dc209/Terem-Moffi"
2025,"Nice","Ligue 1","Youssoufa Moukoko","GER","FW,MF","20-188",2004,2.3,3,2,2,1,0,1,2,50,1,2,0,2,0,3,0,0,"https://fbref.com/en/players/6ce43701/Youssoufa-Moukoko"
2025,"Nice","Ligue 1","Yael Nandjou","FRA","DF","19-325",2005,1.7,4,1,2,1,1,4,8,50,4,4,1,3,4,8,7,0,"https://fbref.com/en/players/35f311ec/Yael-Nandjou"
2025,"Nice","Ligue 1","Youssouf Ndayishimiye","BDI","DF","26-212",1998,21.5,40,21,25,14,1,16,27,59.3,11,35,19,16,21,61,117,4,"https://fbref.com/en/players/65c55288/Youssouf-Ndayishimiye"
2025,"Nice","Ligue 1","Tanguy Ndombele","FRA","MF","28-150",1996,12.6,35,23,10,21,4,12,20,60,8,9,0,9,14,49,9,0,"https://fbref.com/en/players/5cdddffa/Tanguy-Ndombele"
2025,"Nice","Ligue 1","Bernard Nguene","CMR","FW","18-296",2006,0.1,0,0,0,0,0,0,0,NA,0,0,0,0,0,0,0,0,"https://fbref.com/en/players/95915bb5/Bernard-Nguene"
2025,"Nice","Ligue 1","Victor Orakpo","NGA","FW","18-347",2006,0.4,0,0,0,0,0,0,0,NA,0,0,0,0,0,0,0,0,"https://fbref.com/en/players/cbfb7cd7/Victor-Orakpo"
2025,"Nice","Ligue 1","Pablo Rosario","NED","MF,DF","28-140",1997,19.7,30,20,6,19,5,11,20,55,9,19,11,8,31,61,43,2,"https://fbref.com/en/players/1a6b7ea4/Pablo-Rosario"
2025,"Nice","Ligue 1","Morgan Sanson","FRA","MF","30-282",1994,2.6,6,3,2,4,0,1,3,33.3,2,3,0,3,4,10,2,0,"https://fbref.com/en/players/6e7f1353/Morgan-Sanson"
2025,"Nice","Ligue 1","Baptiste Santamaria","FRA","MF","30-079",1995,10.3,20,10,10,7,3,13,22,59.1,9,14,3,11,18,38,19,1,"https://fbref.com/en/players/5e22e2a4/Baptiste-Santamaria"
2025,"Nott'ham Forest","Premier League","Ola Aina","NGA","DF","28-231",1996,33.3,55,42,39,15,1,36,64,56.3,28,34,12,22,33,88,115,4,"https://fbref.com/en/players/246d153b/Ola-Aina"
2025,"Nott'ham Forest","Premier League","Elliot Anderson","ENG","MF","22-202",2002,30.3,92,56,54,29,9,48,111,43.2,63,48,9,39,31,123,76,4,"https://fbref.com/en/players/de31038e/Elliot-Anderson"
2025,"Nott'ham Forest","Premier League","Taiwo Awoniyi","NGA","FW","27-288",1997,4.6,6,3,0,3,3,4,5,80,1,1,0,1,0,6,7,0,"https://fbref.com/en/players/e5478b87/Taiwo-Awoniyi"
2025,"Nott'ham Forest","Premier League","Willy Boly","CIV","DF","34-113",1991,1.7,6,1,5,1,0,4,4,100,0,4,2,2,3,9,12,0,"https://fbref.com/en/players/a4ac4b8f/Willy-Boly"
2025,"Nott'ham Forest","Premier League","Danilo","BRA","MF,FW","24-028",2001,3.1,8,4,7,1,0,3,6,50,3,2,1,1,4,12,3,0,"https://fbref.com/en/players/a816dbfb/Danilo"
2025,"Nott'ham Forest","Premier League","Nicolás Domínguez","ARG","MF,FW","26-333",1998,21.8,86,45,40,35,11,36,76,47.4,40,38,12,26,29,115,54,1,"https://fbref.com/en/players/20b3a502/Nicolas-Dominguez"
2025,"Nott'ham Forest","Premier League","Anthony Elanga","SWE","FW,MF","23-030",2002,27.8,19,14,8,8,3,5,17,29.4,12,11,1,10,6,25,25,0,"https://fbref.com/en/players/2fba6108/Anthony-Elanga"
2025,"Nott'ham Forest","Premier League","Morgan Gibbs-White","ENG","MF","25-120",2000,31.1,43,22,14,23,6,17,33,51.5,16,18,5,13,23,66,29,1,"https://fbref.com/en/players/32f60ed8/Morgan-Gibbs-White"
2025,"Nott'ham Forest","Premier League","Callum Hudson-Odoi","ENG","FW,MF","24-201",2000,24.4,22,14,8,8,6,12,18,66.7,6,11,0,11,13,35,12,1,"https://fbref.com/en/players/15f3ec41/Callum-Hudson-Odoi"
2025,"Nott'ham Forest","Premier League","Nikola Milenković","SRB","DF","27-227",1997,37,51,29,36,13,2,27,34,79.4,7,41,24,17,27,78,209,1,"https://fbref.com/en/players/bee704fc/Nikola-Milenkovic"
2025,"Nott'ham Forest","Premier League","Morato","BRA","DF","23-331",2001,10.1,22,14,18,3,1,13,21,61.9,8,14,5,9,10,32,78,2,"https://fbref.com/en/players/0f41e2ee/Morato"
2025,"Nott'ham Forest","Premier League","Álex Moreno","ESP","DF,MF","31-353",1993,10.6,25,18,20,5,0,15,39,38.5,24,11,5,6,15,40,43,0,"https://fbref.com/en/players/16e9d0ea/Alex-Moreno"
2025,"Nott'ham Forest","Premier League","Murillo","BRA","DF","22-327",2002,35.4,53,36,38,12,3,27,46,58.7,19,69,45,24,36,89,249,3,"https://fbref.com/en/players/1704b0b8/Murillo"
2025,"Nott'ham Forest","Premier League","Ibrahim Sangaré","CIV","MF","27-176",1997,6.6,28,14,8,17,3,8,17,47.1,9,10,4,6,6,34,13,1,"https://fbref.com/en/players/bced0375/Ibrahim-Sangare"
2025,"Nott'ham Forest","Premier League","Matz Sels","BEL","GK","33-090",1992,38,1,1,1,0,0,1,1,100,0,0,0,0,0,1,26,1,"https://fbref.com/en/players/834b5c4c/Matz-Sels"
2025,"Nott'ham Forest","Premier League","Jota Silva","POR","FW,MF","25-299",1999,9.5,27,14,12,13,2,6,27,22.2,21,9,1,8,12,39,17,0,"https://fbref.com/en/players/4d77e622/Jota-Silva"
2025,"Nott'ham Forest","Premier League","Eric da Silva Moreira","GER","MF,DF","19-024",2006,0.3,2,2,2,0,0,2,6,33.3,4,0,0,0,1,3,0,0,"https://fbref.com/en/players/0a4f579a/Eric-da-Silva-Moreira"
2025,"Nott'ham Forest","Premier League","Ramón Sosa","PAR","FW,MF","25-269",1999,3.3,5,3,3,0,2,1,5,20,4,9,0,9,4,9,5,0,"https://fbref.com/en/players/2d3417a1/Ramon-Sosa"
2025,"Nott'ham Forest","Premier League","Harry Toffolo","ENG","DF","29-281",1995,1.5,5,3,3,1,1,3,4,75,1,2,2,0,2,7,12,0,"https://fbref.com/en/players/a105d46a/Harry-Toffolo"
2025,"Nott'ham Forest","Premier League","James Ward-Prowse","ENG","MF","30-207",1994,4.4,4,1,1,3,0,2,2,100,0,3,2,1,5,9,8,0,"https://fbref.com/en/players/3515d404/James-Ward-Prowse"
2025,"Nott'ham Forest","Premier League","Neco Williams","WAL","DF","24-044",2001,28.8,90,57,63,19,8,53,86,61.6,33,42,10,32,31,121,137,3,"https://fbref.com/en/players/dd323728/Neco-Williams"
2025,"Nott'ham Forest","Premier League","Chris Wood","NZL","FW","33-171",1991,32.9,6,5,2,2,2,3,11,27.3,8,12,7,5,5,11,29,1,"https://fbref.com/en/players/4e9a0555/Chris-Wood"
2025,"Nott'ham Forest","Premier League","Ryan Yates","ENG","MF","27-187",1997,21.3,42,21,24,14,4,17,37,45.9,20,38,10,28,26,68,61,1,"https://fbref.com/en/players/c1fe2a48/Ryan-Yates"
2025,"Osasuna","La Liga","Abel","ESP","DF","24-279",2000,23,61,37,28,25,8,39,63,61.9,24,29,4,25,18,79,64,2,"https://fbref.com/en/players/40b6bd38/Abel"
2025,"Osasuna","La Liga","Jesús Areso","ESP","DF","25-329",1999,34.2,53,38,31,14,8,39,56,69.6,17,26,4,22,8,61,92,0,"https://fbref.com/en/players/94e01ec6/Jesus-Areso"
2025,"Osasuna","La Liga","José Arnaiz","ESP","FW,MF","30-042",1995,1.5,7,5,3,3,1,4,7,57.1,3,2,0,2,5,12,1,0,"https://fbref.com/en/players/46e07328/Jose-Arnaiz"
2025,"Osasuna","La Liga","Kike Barja","ESP","FW,MF","28-056",1997,3.5,5,4,1,3,1,2,4,50,2,5,0,5,3,8,4,0,"https://fbref.com/en/players/aad53e64/Kike-Barja"
2025,"Osasuna","La Liga","Iker Benito","ESP","FW,MF","22-290",2002,0.4,0,0,0,0,0,0,1,0,1,0,0,0,1,1,2,0,"https://fbref.com/en/players/50cbc806/Iker-Benito"
2025,"Osasuna","La Liga","Enzo Boyomo","CMR","DF","23-232",2001,33.2,68,43,46,18,4,30,39,76.9,9,34,19,15,44,112,137,3,"https://fbref.com/en/players/3a99bc13/Enzo-Boyomo"
2025,"Osasuna","La Liga","Ante Budimir","CRO","FW","33-309",1991,32.8,20,9,3,11,6,3,13,23.1,10,19,4,15,2,22,26,0,"https://fbref.com/en/players/8f3565b3/Ante-Budimir"
2025,"Osasuna","La Liga","Catena","ESP","DF","30-211",1994,34.2,46,28,34,10,2,27,44,61.4,17,40,25,15,35,81,221,2,"https://fbref.com/en/players/274ab13c/Catena"
2025,"Osasuna","La Liga","Juan Cruz Armada","ESP","DF","32-303",1992,16.6,26,14,11,13,2,15,24,62.5,9,15,4,11,9,35,68,0,"https://fbref.com/en/players/a56da3ba/Juan-Cruz-Armada"
2025,"Osasuna","La Liga","Aitor Fernández","ESP","GK","34-024",1991,1,0,0,0,0,0,0,0,NA,0,0,0,0,0,0,2,0,"https://fbref.com/en/players/a01c3d54/Aitor-Fernandez"
2025,"Osasuna","La Liga","Rubén García","ESP","FW,MF","31-317",1993,26.8,52,31,20,21,11,26,60,43.3,34,37,3,34,15,67,34,1,"https://fbref.com/en/players/5c96b017/Ruben-Garcia"
2025,"Osasuna","La Liga","Unai García","ESP","DF","33-113",1992,0.7,0,0,0,0,0,0,0,NA,0,1,0,1,0,0,1,0,"https://fbref.com/en/players/4a633cfe/Unai-Garcia"
2025,"Osasuna","La Liga","Moi Gómez","ESP","MF,FW","30-338",1994,8.8,13,9,4,7,2,4,8,50,4,5,2,3,6,19,7,1,"https://fbref.com/en/players/5a626448/Moi-Gomez"
2025,"Osasuna","La Liga","Jorge Herrando","ESP","DF","24-088",2001,15.2,17,11,9,5,3,9,15,60,6,20,14,6,12,29,65,2,"https://fbref.com/en/players/e19c989c/Jorge-Herrando"
2025,"Osasuna","La Liga","Sergio Herrera","ESP","GK","31-356",1993,37,2,1,2,0,0,2,6,33.3,4,1,0,1,0,2,29,1,"https://fbref.com/en/players/a4995f48/Sergio-Herrera"
2025,"Osasuna","La Liga","Pablo Ibáñez","ESP","MF","26-249",1998,14.4,20,10,7,12,1,10,40,25,30,20,7,13,18,38,21,0,"https://fbref.com/en/players/3701906c/Pablo-Ibanez"
2025,"Osasuna","La Liga","Javi Martínez","ESP","MF","25-156",1999,0.1,0,0,0,0,0,0,0,NA,0,0,0,0,0,0,0,0,"https://fbref.com/en/players/3672b352/Javi-Martinez"
2025,"Osasuna","La Liga","Jon Moncayola","ESP","MF","27-014",1998,23.3,70,41,29,33,8,31,60,51.7,29,34,3,31,11,81,20,0,"https://fbref.com/en/players/9939e168/Jon-Moncayola"
2025,"Osasuna","La Liga","Iker Muñoz","ESP","MF","22-203",2002,6.8,5,2,3,2,0,3,9,33.3,6,9,2,7,4,9,12,1,"https://fbref.com/en/players/175ece4c/Iker-Munoz"
2025,"Osasuna","La Liga","Aimar Oroz","ESP","MF","23-181",2001,33,35,19,16,13,6,14,46,30.4,32,29,2,27,20,55,10,0,"https://fbref.com/en/players/7c363088/Aimar-Oroz"
2025,"Osasuna","La Liga","Rubén Peña","ESP","FW,DF","33-313",1991,8.6,12,5,4,3,5,5,24,20.8,19,11,0,11,6,18,12,0,"https://fbref.com/en/players/1f079188/Ruben-Pena"
2025,"Osasuna","La Liga","Raúl","ESP","FW,MF","24-205",2000,8.3,13,8,3,6,4,5,10,50,5,4,0,4,0,13,6,0,"https://fbref.com/en/players/18f0a9f0/Raul"
2025,"Osasuna","La Liga","Lucas Torró","ESP","MF","30-312",1994,32.9,74,41,34,35,5,36,64,56.3,28,36,9,27,45,119,70,3,"https://fbref.com/en/players/0e4fef6e/Lucas-Torro"
2025,"Osasuna","La Liga","Nacho Vidal","ESP","DF","30-123",1995,1.4,2,0,0,1,1,1,4,25,3,1,0,1,0,2,6,0,"https://fbref.com/en/players/3a9c4b7b/Nacho-Vidal"
2025,"Osasuna","La Liga","Bryan Zaragoza","ESP","FW,MF","24-032",2001,20.4,13,9,8,4,1,6,21,28.6,15,10,0,10,4,17,8,0,"https://fbref.com/en/players/a96103b2/Bryan-Zaragoza"
2025,"Paris S-G","Ligue 1","Marco Asensio","ESP","FW,MF","29-126",1996,6.9,4,3,1,3,0,0,6,0,6,1,0,1,0,4,1,0,"https://fbref.com/en/players/45af8a54/Marco-Asensio"
2025,"Paris S-G","Ligue 1","Bradley Barcola","FRA","FW","22-267",2002,24.2,27,17,10,8,9,8,31,25.8,23,25,2,23,19,46,12,0,"https://fbref.com/en/players/a0d55a09/Bradley-Barcola"
2025,"Paris S-G","Ligue 1","Lucas Beraldo","BRA","DF","21-184",2003,22.3,38,31,30,8,0,23,37,62.2,14,16,8,8,21,59,63,3,"https://fbref.com/en/players/b8aedf06/Lucas-Beraldo"
2025,"Paris S-G","Ligue 1","Ousmane Dembélé","FRA","FW","28-012",1997,19.2,11,5,0,7,4,4,12,33.3,8,3,0,3,9,20,2,1,"https://fbref.com/en/players/b19db005/Ousmane-Dembele"
2025,"Paris S-G","Ligue 1","Gianluigi Donnarumma","ITA","GK","26-091",1999,23.2,1,1,1,0,0,1,2,50,1,0,0,0,0,1,14,0,"https://fbref.com/en/players/08f5afaa/Gianluigi-Donnarumma"
2025,"Paris S-G","Ligue 1","Désiré Doué","FRA","FW,MF","19-358",2005,19.2,48,30,15,19,14,24,51,47.1,27,26,0,26,13,61,7,0,"https://fbref.com/en/players/9e7483ff/Desire-Doue"
2025,"Paris S-G","Ligue 1","Achraf Hakimi","MAR","DF","26-204",1998,23,48,36,18,20,10,27,55,49.1,28,25,2,23,31,79,18,3,"https://fbref.com/en/players/e42d61c7/Achraf-Hakimi"
2025,"Paris S-G","Ligue 1","Lucas Hernández","FRA","DF","29-102",1996,9.7,24,18,13,9,2,14,23,60.9,9,12,5,7,7,31,37,2,"https://fbref.com/en/players/c3ee18ef/Lucas-Hernandez"
2025,"Paris S-G","Ligue 1","Noham Kamara","FRA","DF","18-125",2007,0.8,1,1,0,1,0,0,0,NA,0,1,1,0,1,2,1,0,"https://fbref.com/en/players/1a7cfdea/Noham-Kamara"
2025,"Paris S-G","Ligue 1","Lee Kang-in","KOR","FW,MF","24-097",2001,18.5,25,17,7,11,7,19,35,54.3,16,11,1,10,3,28,3,1,"https://fbref.com/en/players/8455ad90/Lee-Kang-in"
2025,"Paris S-G","Ligue 1","Presnel Kimpembe","FRA","DF","29-287",1995,0.3,1,0,1,0,0,0,0,NA,0,2,2,0,0,1,1,0,"https://fbref.com/en/players/aef6e670/Presnel-Kimpembe"
2025,"Paris S-G","Ligue 1","Randal Kolo Muani","FRA","FW","26-173",1998,4,4,4,1,1,2,0,2,0,2,1,0,1,0,4,5,0,"https://fbref.com/en/players/c0b3669f/Randal-Kolo-Muani"
2025,"Paris S-G","Ligue 1","Khvicha Kvaratskhelia","GEO","FW","24-104",2001,10.2,19,13,4,12,3,13,23,56.5,10,7,0,7,2,21,4,0,"https://fbref.com/en/players/dea88efd/Khvicha-Kvaratskhelia"
2025,"Paris S-G","Ligue 1","Marquinhos","BRA","DF","31-013",1994,19.2,30,19,8,16,6,25,33,75.8,8,27,15,12,11,41,64,0,"https://fbref.com/en/players/d5f2f82b/Marquinhos"
2025,"Paris S-G","Ligue 1","Senny Mayulu","FRA","MF","19-010",2006,9,25,16,8,14,3,8,14,57.1,6,8,3,5,5,30,12,0,"https://fbref.com/en/players/bac89b96/Senny-Mayulu"
2025,"Paris S-G","Ligue 1","Ibrahim Mbaye","FRA","FW,MF","17-123",2008,3.8,4,2,1,2,1,3,8,37.5,5,2,0,2,2,6,2,0,"https://fbref.com/en/players/201b4ee4/Ibrahim-Mbaye"
2025,"Paris S-G","Ligue 1","Nuno Mendes","POR","DF","22-342",2002,18.6,30,19,15,12,3,23,39,59,16,25,8,17,18,48,37,2,"https://fbref.com/en/players/f20e4cc9/Nuno-Mendes"
2025,"Paris S-G","Ligue 1","João Neves","POR","MF,DF","20-242",2004,20.5,63,31,20,26,17,27,45,60,18,29,9,20,23,86,22,1,"https://fbref.com/en/players/c2a15a27/Joao-Neves"
2025,"Paris S-G","Ligue 1","Willian Pacho","ECU","DF","23-223",2001,23.7,56,32,34,22,0,23,32,71.9,9,35,22,13,40,96,91,1,"https://fbref.com/en/players/ecbe2839/Willian-Pacho"
2025,"Paris S-G","Ligue 1","Gonçalo Ramos","POR","FW","23-341",2001,11.8,11,6,5,5,1,3,6,50,3,5,1,4,0,11,5,0,"https://fbref.com/en/players/f63cda26/Goncalo-Ramos"
2025,"Paris S-G","Ligue 1","Fabián Ruiz Peña","ESP","MF","29-054",1996,21.4,37,24,13,15,9,21,47,44.7,26,25,3,22,16,53,27,1,"https://fbref.com/en/players/c0c7ff58/Fabian-Ruiz-Pena"
2025,"Paris S-G","Ligue 1","Matvei Safonov","RUS","GK","26-091",1999,9.8,0,0,0,0,0,0,0,NA,0,1,0,1,1,1,3,0,"https://fbref.com/en/players/d97b252e/Matvei-Safonov"
2025,"Paris S-G","Ligue 1","Milan Škriniar","SVK","DF","30-105",1995,4.2,7,5,3,4,0,3,3,100,0,7,6,1,3,10,16,0,"https://fbref.com/en/players/30f5ffa9/Milan-Skriniar"
2025,"Paris S-G","Ligue 1","Axel Tapé","FRA","DF,MF","17-290",2007,2,3,1,1,2,0,2,2,100,0,2,2,0,1,4,5,0,"https://fbref.com/en/players/75cde619/Axel-Tape"
2025,"Paris S-G","Ligue 1","Arnau Tenas","ESP","GK","23-362",2001,1,0,0,0,0,0,0,0,NA,0,0,0,0,0,0,0,0,"https://fbref.com/en/players/30670b0e/Arnau-Tenas"
2025,"Paris S-G","Ligue 1","Vitinha","POR","MF","25-103",2000,22.7,43,23,13,27,3,25,48,52.1,23,26,7,19,14,57,19,2,"https://fbref.com/en/players/3b029691/Vitinha"
2025,"Paris S-G","Ligue 1","Yoram Zague","FRA","DF,FW","19-012",2006,2,8,6,3,1,4,6,8,75,2,3,0,3,2,10,2,0,"https://fbref.com/en/players/5ce497e2/Yoram-Zague"
2025,"Paris S-G","Ligue 1","Warren Zaïre-Emery","FRA","MF,DF","19-080",2006,22.8,51,26,17,21,13,23,45,51.1,22,35,6,29,23,74,20,2,"https://fbref.com/en/players/6b9960cf/Warren-Zaire-Emery"
2025,"Parma","Serie A","Pontus Almqvist","SWE","FW,MF","25-321",1999,12.4,17,13,7,7,3,8,17,47.1,9,13,0,13,19,36,8,0,"https://fbref.com/en/players/0917188a/Pontus-Almqvist"
2025,"Parma","Serie A","Botond Balogh","HUN","DF","22-355",2002,22.8,36,16,22,13,1,20,28,71.4,8,34,26,8,25,61,141,2,"https://fbref.com/en/players/348bafd4/Botond-Balogh"
2025,"Parma","Serie A","Adrian Benedyczak","POL","FW,MF","24-184",2000,2.4,0,0,0,0,0,0,1,0,1,3,1,2,0,0,8,0,"https://fbref.com/en/players/3f448184/Adrian-Benedyczak"
2025,"Parma","Serie A","Adrian Bernabe","ESP","MF","24-001",2001,16.1,29,18,16,9,4,14,32,43.8,18,22,9,13,7,36,26,1,"https://fbref.com/en/players/548672b4/Adrian-Bernabe"
2025,"Parma","Serie A","Ange-Yoan Bonny","FRA","FW","21-214",2003,28.1,34,16,4,23,7,8,14,57.1,6,17,2,15,3,37,17,0,"https://fbref.com/en/players/64629ba4/Ange-Yoan-Bonny"
2025,"Parma","Serie A","Drissa Camara","CIV","MF,FW","23-098",2002,5,9,7,2,6,1,1,10,10,9,8,0,8,3,12,1,0,"https://fbref.com/en/players/543d9d2b/Drissa-Camara"
2025,"Parma","Serie A","Matteo Cancellieri","ITA","FW,MF","23-104",2002,15.8,26,16,15,9,2,11,32,34.4,21,15,1,14,13,39,30,0,"https://fbref.com/en/players/b6a1cdf9/Matteo-Cancellieri"
2025,"Parma","Serie A","Gabriel Charpentier","CGO","FW","26-010",1999,3,4,3,2,1,1,3,4,75,1,3,0,3,0,4,9,0,"https://fbref.com/en/players/c52bea9e/Gabriel-Charpentier"
2025,"Parma","Serie A","Leandro Chichizola","ARG","GK","35-061",1990,1,0,0,0,0,0,0,0,NA,0,0,0,0,0,0,2,0,"https://fbref.com/en/players/8d957256/Leandro-Chichizola"
2025,"Parma","Serie A","Alessandro Circati","AUS","DF","21-229",2003,6,7,5,6,1,0,1,2,50,1,5,4,1,3,10,42,1,"https://fbref.com/en/players/1223765c/Alessandro-Circati"
2025,"Parma","Serie A","Woyo Coulibaly","FRA","DF","26-007",1999,12,13,10,9,2,2,5,11,45.5,6,19,2,17,8,21,25,0,"https://fbref.com/en/players/beb6e3a6/Woyo-Coulibaly"
2025,"Parma","Serie A","Wylan Cyprien","FRA","MF","30-119",1995,0.3,0,0,0,0,0,0,1,0,1,1,0,1,1,1,0,0,"https://fbref.com/en/players/3e092724/Wylan-Cyprien"
2025,"Parma","Serie A","Enrico Del Prato","ITA","DF","25-198",1999,32.7,33,17,24,8,1,19,26,73.1,7,69,35,34,19,52,132,2,"https://fbref.com/en/players/4c6f9258/Enrico-Del-Prato"
2025,"Parma","Serie A","Nahuel Estévez","ARG","MF","29-194",1995,7.3,16,6,7,8,1,6,15,40,9,9,2,7,3,19,26,0,"https://fbref.com/en/players/cec60a2f/Nahuel-Estevez"
2025,"Parma","Serie A","Antoine Hainaut","FRA","DF,FW","23-098",2002,13.4,26,14,15,8,3,9,13,69.2,4,17,4,13,15,41,59,1,"https://fbref.com/en/players/6503f220/Antoine-Hainaut"
2025,"Parma","Serie A","Mohamed Haj","TUN","MF","20-062",2005,5,3,1,2,1,0,1,2,50,1,3,1,2,4,7,5,0,"https://fbref.com/en/players/eb7dc619/Mohamed-Haj"
2025,"Parma","Serie A","Hernani","BRA","MF","31-061",1994,14.7,47,26,25,18,4,27,50,54,23,26,6,20,19,66,12,1,"https://fbref.com/en/players/6f5ead86/Hernani"
2025,"Parma","Serie A","Mandela Keita","BEL","MF","23-017",2002,20.3,44,25,13,25,6,18,35,51.4,17,18,7,11,21,65,29,2,"https://fbref.com/en/players/f5692b25/Mandela-Keita"
2025,"Parma","Serie A","Mateusz Kowalski","POL","MF","19-310",2005,0.6,0,0,0,0,0,0,0,NA,0,1,0,1,0,0,1,0,"https://fbref.com/en/players/d2bb908c/Mateusz-Kowalski"
2025,"Parma","Serie A","Giovanni Leoni","ITA","DF","18-157",2006,13.3,14,6,10,4,0,5,10,50,5,20,11,9,15,29,63,1,"https://fbref.com/en/players/570888ce/Giovanni-Leoni"
2025,"Parma","Serie A","Mathias Løvik","NOR","DF,FW","21-172",2003,1,1,0,0,1,0,1,3,33.3,2,1,1,0,2,3,3,0,"https://fbref.com/en/players/f17aa65c/Mathias-Lovik"
2025,"Parma","Serie A","Dennis Man","ROU","FW,MF","26-274",1998,22.2,13,6,7,3,3,6,24,25,18,15,3,12,8,21,11,0,"https://fbref.com/en/players/2079b3cc/Dennis-Man"
2025,"Parma","Serie A","Valentin Mihaila","ROU","FW,MF","25-114",2000,14.3,29,15,8,13,8,9,22,40.9,13,18,0,18,8,37,6,0,"https://fbref.com/en/players/81a4c239/Valentin-Mihaila"
2025,"Parma","Serie A","Jacob Ondrejka","SWE","MF,FW","22-267",2002,4.7,12,6,5,7,0,10,12,83.3,2,2,0,2,7,19,2,0,"https://fbref.com/en/players/752e09ed/Jacob-Ondrejka"
2025,"Parma","Serie A","Yordan Osorio","VEN","DF","31-017",1994,1.9,5,3,4,1,0,2,2,100,0,3,1,2,4,9,6,1,"https://fbref.com/en/players/4d17df3e/Yordan-Osorio"
2025,"Parma","Serie A","Mateo Pellegrino","ARG","FW","24-087",2001,8.2,3,2,1,2,0,1,4,25,3,6,1,5,1,4,6,0,"https://fbref.com/en/players/8c9e96c5/Mateo-Pellegrino"
2025,"Parma","Serie A","Simon Sohm","SUI","MF","24-046",2001,33.2,28,17,11,13,4,16,35,45.7,19,11,3,8,26,54,36,0,"https://fbref.com/en/players/a5f458d9/Simon-Sohm"
2025,"Parma","Serie A","Zion Suzuki","JPN","GK","22-279",2002,36.8,1,0,1,0,0,1,2,50,1,0,0,0,0,1,35,4,"https://fbref.com/en/players/51e1f4f5/Zion-Suzuki"
2025,"Parma","Serie A","Lautaro Valenti","ARG","DF","26-133",1999,17.3,17,12,13,3,1,7,9,77.8,2,26,13,13,13,30,94,1,"https://fbref.com/en/players/55db5c36/Lautaro-Valenti"
2025,"Parma","Serie A","Emanuele Valeri","ITA","DF","26-171",1998,31.9,51,31,33,15,3,30,61,49.2,31,31,10,21,29,80,103,4,"https://fbref.com/en/players/ec52b661/Emanuele-Valeri"
2025,"Parma","Serie A","Alessandro Vogliacco","ITA","DF","26-255",1998,8.6,5,2,5,0,0,3,5,60,2,15,10,5,3,8,37,0,"https://fbref.com/en/players/6841f107/Alessandro-Vogliacco"
2025,"Parma","Serie A","Milan Đurić","BIH","FW","35-005",1990,3,0,0,0,0,0,0,2,0,2,3,0,3,0,0,2,0,"https://fbref.com/en/players/405f6586/Milan-Djuric"
2025,"RB Leipzig","Bundesliga","Ridle Baku","GER","DF,MF","27-049",1998,14.2,24,19,9,13,2,9,23,39.1,14,18,2,16,9,33,45,0,"https://fbref.com/en/players/442b56fa/Ridle-Baku"
2025,"RB Leipzig","Bundesliga","Christoph Baumgartner","AUT","MF","25-299",1999,17.9,44,28,13,19,12,17,42,40.5,25,45,9,36,12,56,24,2,"https://fbref.com/en/players/437f2b00/Christoph-Baumgartner"
2025,"RB Leipzig","Bundesliga","El Chadaille Bitshiabu","FRA","DF","20-011",2005,12.6,27,18,17,9,1,10,19,52.6,9,25,14,11,13,40,97,2,"https://fbref.com/en/players/2180c761/El-Chadaille-Bitshiabu"
2025,"RB Leipzig","Bundesliga","Elif Elmas","MKD","MF","25-245",1999,0.5,3,1,3,0,0,1,3,33.3,2,2,0,2,0,3,2,0,"https://fbref.com/en/players/cf007308/Elif-Elmas"
2025,"RB Leipzig","Bundesliga","Viggo Gebel","GER","MF","17-186",2007,0.2,0,0,0,0,0,0,0,NA,0,0,0,0,0,0,0,0,"https://fbref.com/en/players/92ed2acc/Viggo-Gebel"
2025,"RB Leipzig","Bundesliga","Lutsharel Geertruida","NED","DF","24-313",2000,17.3,35,24,24,11,0,15,31,48.4,16,15,4,11,16,51,59,4,"https://fbref.com/en/players/242e1043/Lutsharel-Geertruida"
2025,"RB Leipzig","Bundesliga","Tidiam Gomis","FRA","MF,FW","18-292",2006,1.7,0,0,0,0,0,0,0,NA,0,2,0,2,1,1,0,0,"https://fbref.com/en/players/64c705d7/Tidiam-Gomis"
2025,"RB Leipzig","Bundesliga","Péter Gulácsi","HUN","GK","35-021",1990,29.2,1,1,1,0,0,1,2,50,1,0,0,0,0,1,16,4,"https://fbref.com/en/players/bcb2ccd8/Peter-Gulacsi"
2025,"RB Leipzig","Bundesliga","Amadou Haidara","MLI","MF","27-116",1998,14.7,30,17,12,16,2,12,29,41.4,17,42,12,30,18,48,56,1,"https://fbref.com/en/players/92432bc6/Amadou-Haidara"
2025,"RB Leipzig","Bundesliga","Benjamin Henrichs","GER","DF","28-093",1997,10.4,32,16,18,10,4,14,27,51.9,13,22,3,19,15,47,33,0,"https://fbref.com/en/players/0a89e877/Benjamin-Henrichs"
2025,"RB Leipzig","Bundesliga","Kevin Kampl","SVN","MF","34-230",1990,17.7,27,18,11,10,6,16,26,61.5,10,25,6,19,24,51,25,0,"https://fbref.com/en/players/b825a650/Kevin-Kampl"
2025,"RB Leipzig","Bundesliga","Lukas Klostermann","GER","DF","28-358",1996,20.4,27,14,18,7,2,14,24,58.3,10,31,17,14,24,51,143,3,"https://fbref.com/en/players/ca8033cb/Lukas-Klostermann"
2025,"RB Leipzig","Bundesliga","Castello Lukeba","FRA","DF","22-161",2002,17.5,31,17,15,12,4,17,24,70.8,7,29,12,17,17,48,74,0,"https://fbref.com/en/players/5b9512c5/Castello-Lukeba"
2025,"RB Leipzig","Bundesliga","Kosta Nedeljković","SRB","DF","19-162",2005,5.3,11,8,5,6,0,6,10,60,4,6,4,2,2,13,14,0,"https://fbref.com/en/players/c70be9cf/Kosta-Nedeljkovic"
2025,"RB Leipzig","Bundesliga","Antonio Nusa","NOR","MF,DF","20-040",2005,17.3,30,17,16,9,5,18,36,50,18,22,2,20,8,38,11,0,"https://fbref.com/en/players/4ab12002/Antonio-Nusa"
2025,"RB Leipzig","Bundesliga","Loïs Openda","BEL","FW,MF","25-100",2000,27.3,9,4,3,4,2,3,11,27.3,8,19,1,18,5,14,12,0,"https://fbref.com/en/players/8652a85c/Lois-Openda"
2025,"RB Leipzig","Bundesliga","Willi Orban","HUN","DF","32-205",1992,24.7,38,21,23,14,1,23,32,71.9,9,45,31,14,21,59,169,4,"https://fbref.com/en/players/20030c06/Willi-Orban"
2025,"RB Leipzig","Bundesliga","Assan Ouedraogo","GER","MF","19-018",2006,0.6,0,0,0,0,0,0,0,NA,0,1,0,1,0,0,0,0,"https://fbref.com/en/players/75e6fc2f/Assan-Ouedraogo"
2025,"RB Leipzig","Bundesliga","Yussuf Poulsen","DEN","FW,MF","30-346",1994,4.2,10,5,2,6,2,4,8,50,4,7,2,5,0,10,14,0,"https://fbref.com/en/players/d2416c2e/Yussuf-Poulsen"
2025,"RB Leipzig","Bundesliga","David Raum","GER","DF","27-035",1998,19.8,38,28,16,14,8,20,35,57.1,15,25,8,17,9,47,47,4,"https://fbref.com/en/players/7d450ed3/David-Raum"
2025,"RB Leipzig","Bundesliga","Faik Sakar","GER","MF","17-133",2008,0,0,0,0,0,0,0,0,NA,0,0,0,0,0,0,0,0,"https://fbref.com/en/players/85c3052c/Faik-Sakar"
2025,"RB Leipzig","Bundesliga","Xaver Schlager","AUT","MF","27-241",1997,2,4,2,2,1,1,3,7,42.9,4,7,0,7,0,4,3,0,"https://fbref.com/en/players/8f056768/Xaver-Schlager"
2025,"RB Leipzig","Bundesliga","Nicolas Seiwald","AUT","MF,DF","24-023",2001,23.2,53,31,19,29,5,25,50,50,25,43,10,33,31,84,76,2,"https://fbref.com/en/players/28c6e925/Nicolas-Seiwald"
2025,"RB Leipzig","Bundesliga","Benjamin Šeško","SVN","FW,MF","21-361",2003,26.4,7,3,0,4,3,3,11,27.3,8,15,4,11,5,12,20,0,"https://fbref.com/en/players/3260690c/Benjamin-Sesko"
2025,"RB Leipzig","Bundesliga","André Silva","POR","FW,MF","29-202",1995,1.5,1,1,1,0,0,0,1,0,1,1,0,1,1,2,2,0,"https://fbref.com/en/players/3effaa34/Andre-Silva"
2025,"RB Leipzig","Bundesliga","Mohamed Simakan","FRA","DF","25-024",2000,0.6,0,0,0,0,0,0,0,NA,0,0,0,0,2,2,0,0,"https://fbref.com/en/players/fcb27134/Mohamed-Simakan"
2025,"RB Leipzig","Bundesliga","Xavi Simons","NED","MF","22-036",2003,23.9,28,21,5,15,8,12,26,46.2,14,19,3,16,12,40,19,1,"https://fbref.com/en/players/da4d670f/Xavi-Simons"
2025,"RB Leipzig","Bundesliga","Maarten Vandevoordt","BEL","GK","23-090",2002,4.8,1,0,1,0,0,1,1,100,0,0,0,0,0,1,4,0,"https://fbref.com/en/players/f9e0c603/Maarten-Vandevoordt"
2025,"RB Leipzig","Bundesliga","Arthur Vermeeren","BEL","MF","20-109",2005,17.5,32,19,14,13,5,14,47,29.8,33,34,12,22,23,55,25,2,"https://fbref.com/en/players/722494dc/Arthur-Vermeeren"
2025,"Rayo Vallecano","La Liga","Iván Balliu","ALB","DF","33-146",1992,13.3,17,14,8,5,4,6,18,33.3,12,16,4,12,13,30,39,0,"https://fbref.com/en/players/cee88597/Ivan-Balliu"
2025,"Rayo Vallecano","La Liga","Augusto Batalla","ARG","GK","29-027",1996,32,4,2,4,0,0,4,6,66.7,2,0,0,0,0,4,15,4,"https://fbref.com/en/players/fc627681/Augusto-Batalla"
2025,"Rayo Vallecano","La Liga","Sergio Camello","ESP","FW","24-106",2001,12.6,9,3,2,5,2,4,6,66.7,2,8,1,7,4,13,16,0,"https://fbref.com/en/players/873619c6/Sergio-Camello"
2025,"Rayo Vallecano","La Liga","Cárdenas","ESP","GK","28-060",1997,6,0,0,0,0,0,0,0,NA,0,0,0,0,0,0,3,0,"https://fbref.com/en/players/e1846dde/Cardenas"
2025,"Rayo Vallecano","La Liga","Pep Chavarría","ESP","DF,FW","27-047",1998,28.7,46,36,30,14,2,28,45,62.2,17,35,9,26,30,76,108,1,"https://fbref.com/en/players/63c5e56b/Pep-Chavarria"
2025,"Rayo Vallecano","La Liga","Pathé Ciss","SEN","MF,DF","31-072",1994,23.8,49,24,26,22,1,20,41,48.8,21,31,10,21,40,89,61,3,"https://fbref.com/en/players/9a0408b6/Pathe-Ciss"
2025,"Rayo Vallecano","La Liga","Pedro Díaz","ESP","MF","26-356",1998,13.5,23,15,7,14,2,14,41,34.1,27,16,0,16,7,30,7,1,"https://fbref.com/en/players/eea5130e/Pedro-Diaz"
2025,"Rayo Vallecano","La Liga","Adri Embarba","ESP","FW,MF","33-020",1992,17.9,41,20,17,17,7,18,47,38.3,29,18,1,17,13,54,14,2,"https://fbref.com/en/players/db8f0eba/Adri-Embarba"
2025,"Rayo Vallecano","La Liga","Alfonso Espino","URU","DF","33-142",1992,9.3,41,24,31,8,2,26,47,55.3,21,19,6,13,12,53,32,1,"https://fbref.com/en/players/db001fa9/Alfonso-Espino"
2025,"Rayo Vallecano","La Liga","Etienne Eto'o","CMR","FW","22-282",2002,0.4,0,0,0,0,0,0,1,0,1,0,0,0,0,0,1,0,"https://fbref.com/en/players/7ecd41a2/Etienne-Etoo"
2025,"Rayo Vallecano","La Liga","Pelayo Fernandez","ESP","DF","22-028",2003,1.1,0,0,0,0,0,0,0,NA,0,0,0,0,2,2,9,0,"https://fbref.com/en/players/ce46e850/Pelayo-Fernandez"
2025,"Rayo Vallecano","La Liga","Jorge de Frutos","ESP","FW,MF","28-096",1997,27.7,37,21,16,13,8,14,46,30.4,32,22,0,22,19,56,24,1,"https://fbref.com/en/players/38ce1150/Jorge-de-Frutos"
2025,"Rayo Vallecano","La Liga","Álvaro García","ESP","FW,MF","32-212",1992,28.4,33,24,19,8,6,12,31,38.7,19,31,0,31,32,65,42,1,"https://fbref.com/en/players/90bbd822/Alvaro-Garcia"
2025,"Rayo Vallecano","La Liga","Sergi Guardiola","ESP","FW","33-363",1991,4,5,3,0,5,0,2,3,66.7,1,1,0,1,1,6,2,0,"https://fbref.com/en/players/32974271/Sergi-Guardiola"
2025,"Rayo Vallecano","La Liga","Gerard Gumbau","ESP","MF","30-160",1994,9.4,17,12,8,7,2,7,15,46.7,8,13,4,9,5,22,13,0,"https://fbref.com/en/players/ac454a4f/Gerard-Gumbau"
2025,"Rayo Vallecano","La Liga","Aridane Hernández","ESP","DF","36-065",1989,11.4,13,11,9,4,0,6,8,75,2,10,8,2,6,19,99,2,"https://fbref.com/en/players/132ac341/Aridane-Hernandez"
2025,"Rayo Vallecano","La Liga","Florian Lejeune","FRA","DF","34-007",1991,36.9,46,28,30,14,2,23,43,53.5,20,38,32,6,41,87,181,1,"https://fbref.com/en/players/6eaed4eb/Florian-Lejeune"
2025,"Rayo Vallecano","La Liga","Unai López","ESP","MF","29-209",1995,19,31,21,14,12,5,17,36,47.2,19,18,6,12,21,52,20,0,"https://fbref.com/en/players/88050721/Unai-Lopez"
2025,"Rayo Vallecano","La Liga","Abdul Mumin","GHA","DF","26-355",1998,22.4,37,25,30,7,0,17,27,63,10,40,29,11,23,60,125,0,"https://fbref.com/en/players/5487adcd/Abdul-Mumin"
2025,"Rayo Vallecano","La Liga","Randy Nteka","ANG","FW","27-172",1997,12.5,16,5,3,9,4,5,12,41.7,7,13,2,11,4,20,20,0,"https://fbref.com/en/players/a6103274/Randy-Nteka"
2025,"Rayo Vallecano","La Liga","Isaac Palazón Camacho","ESP","MF,FW","30-151",1994,24,22,17,10,6,6,8,34,23.5,26,22,3,19,8,30,13,1,"https://fbref.com/en/players/49dbab27/Isaac-Palazon-Camacho"
2025,"Rayo Vallecano","La Liga","Andrei Ratiu","ROU","DF","26-341",1998,34.1,71,41,40,21,10,42,70,60,28,45,5,40,27,98,73,2,"https://fbref.com/en/players/b1b99435/Andrei-Ratiu"
2025,"Rayo Vallecano","La Liga","James Rodríguez","COL","MF,FW","33-319",1991,1.6,3,2,1,2,0,0,2,0,2,2,0,2,1,4,0,0,"https://fbref.com/en/players/715bf047/James-Rodriguez"
2025,"Rayo Vallecano","La Liga","Raúl de Tomás","ESP","DF,FW","30-222",1994,0.2,2,2,1,0,1,0,0,NA,0,0,0,0,0,2,0,0,"https://fbref.com/en/players/02ef8778/Raul-de-Tomas"
2025,"Rayo Vallecano","La Liga","Óscar Trejo","ARG","MF","37-031",1988,5.5,8,5,1,5,2,3,9,33.3,6,9,0,9,4,12,5,0,"https://fbref.com/en/players/fc647b34/Oscar-Trejo"
2025,"Rayo Vallecano","La Liga","Óscar Valentín","ESP","MF","30-280",1994,20.4,55,41,21,20,14,33,76,43.4,43,36,8,28,21,76,51,2,"https://fbref.com/en/players/592f3158/Oscar-Valentin"
2025,"Real Madrid","La Liga","Lorenzo Aguado","ESP","DF","22-250",2002,0.1,0,0,0,0,0,0,0,NA,0,0,0,0,0,0,2,0,"https://fbref.com/en/players/beae81e1/Lorenzo-Aguado"
2025,"Real Madrid","La Liga","David Alaba","AUT","DF","32-337",1992,3.5,1,0,1,0,0,0,0,NA,0,5,5,0,6,7,7,0,"https://fbref.com/en/players/05439de2/David-Alaba"
2025,"Real Madrid","La Liga","Raúl Asencio","ESP","DF","22-103",2003,18.6,22,16,18,4,0,10,13,76.9,3,11,6,5,16,38,88,2,"https://fbref.com/en/players/4731cd4c/Raul-Asencio"
2025,"Real Madrid","La Liga","Jude Bellingham","ENG","MF","21-332",2003,27.6,61,33,20,27,14,28,42,66.7,14,37,2,35,28,89,23,1,"https://fbref.com/en/players/57d88cf9/Jude-Bellingham"
2025,"Real Madrid","La Liga","Eduardo Camavinga","FRA","MF,DF","22-198",2002,12.2,42,26,23,16,3,19,33,57.6,14,24,8,16,18,60,23,0,"https://fbref.com/en/players/7b9c2d84/Eduardo-Camavinga"
2025,"Real Madrid","La Liga","Dani Carvajal","ESP","DF","33-136",1992,6.8,12,8,7,3,2,9,12,75,3,8,3,5,10,22,19,1,"https://fbref.com/en/players/4958bfb2/Dani-Carvajal"
2025,"Real Madrid","La Liga","Dani Ceballos","ESP","MF","28-293",1996,13.5,41,21,17,18,6,20,40,50,20,16,4,12,14,55,10,2,"https://fbref.com/en/players/c0617e2b/Dani-Ceballos"
2025,"Real Madrid","La Liga","Chema","ESP","MF","20-032",2005,0.1,0,0,0,0,0,0,0,NA,0,0,0,0,0,0,1,0,"https://fbref.com/en/players/39ef21fa/Chema"
2025,"Real Madrid","La Liga","Thibaut Courtois","BEL","GK","33-016",1992,30,0,0,0,0,0,0,0,NA,0,0,0,0,1,1,15,1,"https://fbref.com/en/players/1840e36d/Thibaut-Courtois"
2025,"Real Madrid","La Liga","Brahim Díaz","MAR","FW,MF","25-297",1999,15.4,25,19,9,13,3,7,19,36.8,12,16,1,15,4,29,2,1,"https://fbref.com/en/players/407feb71/Brahim-Diaz"
2025,"Real Madrid","La Liga","Endrick","BRA","FW","18-310",2006,4,1,1,1,0,0,1,3,33.3,2,0,0,0,4,5,1,0,"https://fbref.com/en/players/a2728fbf/Endrick"
2025,"Real Madrid","La Liga","Fran","ESP","GK","19-337",2005,1,0,0,0,0,0,0,0,NA,0,0,0,0,0,0,2,0,"https://fbref.com/en/players/5e550a91/Fran"
2025,"Real Madrid","La Liga","Fran Garcia","ESP","DF","25-286",1999,24.1,51,36,29,16,6,28,51,54.9,23,27,5,22,28,79,67,1,"https://fbref.com/en/players/7226539b/Fran-Garcia"
2025,"Real Madrid","La Liga","Gonzalo García","ESP","FW,DF","21-064",2004,0.6,0,0,0,0,0,0,0,NA,0,1,0,1,0,0,0,0,"https://fbref.com/en/players/74c2d562/Gonzalo-Garcia"
2025,"Real Madrid","La Liga","Arda Güler","TUR","MF,FW","20-091",2005,13.9,30,16,11,8,11,9,22,40.9,13,18,0,18,7,37,8,0,"https://fbref.com/en/players/3741ca58/Arda-Guler"
2025,"Real Madrid","La Liga","Vinicius Júnior","BRA","FW","24-319",2000,25,21,10,7,4,10,5,18,27.8,13,9,0,9,3,24,1,2,"https://fbref.com/en/players/7111d552/Vinicius-Junior"
2025,"Real Madrid","La Liga","Andriy Lunin","UKR","GK","26-105",1999,7,1,0,1,0,0,0,0,NA,0,0,0,0,0,1,3,0,"https://fbref.com/en/players/3061e1ec/Andriy-Lunin"
2025,"Real Madrid","La Liga","Kylian Mbappé","FRA","FW","26-158",1998,32.3,8,5,1,3,4,1,5,20,4,3,0,3,1,9,1,1,"https://fbref.com/en/players/42fd9c7f/Kylian-Mbappe"
2025,"Real Madrid","La Liga","Ferland Mendy","FRA","DF","29-353",1995,11.2,17,14,7,6,4,9,12,75,3,11,4,7,9,26,8,1,"https://fbref.com/en/players/3cefcaef/Ferland-Mendy"
2025,"Real Madrid","La Liga","Éder Militão","BRA","DF","27-129",1998,10.4,19,17,14,5,0,7,12,58.3,5,13,8,5,12,31,35,0,"https://fbref.com/en/players/2784f898/Eder-Militao"
2025,"Real Madrid","La Liga","Luka Modrić","CRO","MF","39-260",1985,20.3,31,20,16,13,2,14,32,43.8,18,17,5,12,27,58,17,0,"https://fbref.com/en/players/6025fab1/Luka-Modric"
2025,"Real Madrid","La Liga","Víctor Muñoz","ESP","FW,DF","21-318",2003,0.4,0,0,0,0,0,0,0,NA,0,0,0,0,0,0,0,0,"https://fbref.com/en/players/f8b5680f/Victor-Munoz"
2025,"Real Madrid","La Liga","Jacobo Ramón","ESP","DF","20-141",2005,2.3,7,3,4,3,0,2,2,100,0,1,0,1,3,10,8,2,"https://fbref.com/en/players/4772b1d1/Jacobo-Ramon"
2025,"Real Madrid","La Liga","Rodrygo","BRA","FW,MF","24-138",2001,21.4,21,14,14,5,2,7,23,30.4,16,18,1,17,11,32,9,0,"https://fbref.com/en/players/8f5e92a6/Rodrygo"
2025,"Real Madrid","La Liga","Antonio Rüdiger","GER","DF","32-085",1993,25.5,20,13,14,6,0,11,15,73.3,4,22,14,8,9,29,96,1,"https://fbref.com/en/players/18b896d6/Antonio-Rudiger"
2025,"Real Madrid","La Liga","Aurélien Tchouaméni","FRA","DF,MF","25-120",2000,29.9,47,23,25,19,3,21,41,51.2,20,34,25,9,46,93,92,1,"https://fbref.com/en/players/4f255115/Aurelien-Tchouameni"
2025,"Real Madrid","La Liga","Jesús Vallejo","ESP","DF","28-142",1997,1.5,0,0,0,0,0,0,0,NA,0,0,0,0,2,2,8,0,"https://fbref.com/en/players/c2111b45/Jesus-Vallejo"
2025,"Real Madrid","La Liga","Federico Valverde","URU","MF,DF","26-309",1998,33.7,50,30,22,23,5,29,43,67.4,14,38,8,30,55,105,52,1,"https://fbref.com/en/players/0959c2a2/Federico-Valverde"
2025,"Real Madrid","La Liga","Lucas Vázquez","ESP","DF","33-330",1991,24.3,58,34,33,17,8,27,48,56.3,21,24,6,18,17,75,35,1,"https://fbref.com/en/players/fd51b456/Lucas-Vazquez"
2025,"Real Madrid","La Liga","Daniel Yáñez","ESP","FW","18-060",2007,0,0,0,0,0,0,0,0,NA,0,0,0,0,0,0,0,0,"https://fbref.com/en/players/79310b33/Daniel-Yanez"
2025,"Real Sociedad","La Liga","Nayef Aguerd","MAR","DF","29-058",1996,19.6,30,24,17,12,1,12,18,66.7,6,21,15,6,13,43,91,0,"https://fbref.com/en/players/288e1e13/Nayef-Aguerd"
2025,"Real Sociedad","La Liga","Jon Aramburu","VEN","DF","22-308",2002,27.3,102,70,61,30,11,66,100,66,34,40,8,32,30,132,98,0,"https://fbref.com/en/players/dc7a172e/Jon-Aramburu"
2025,"Real Sociedad","La Liga","Ander Barrenetxea","ESP","MF,FW","23-151",2001,14,26,19,7,14,5,6,23,26.1,17,15,0,15,11,37,16,1,"https://fbref.com/en/players/200e89e1/Ander-Barrenetxea"
2025,"Real Sociedad","La Liga","Sheraldo Becker","SUR","FW,MF","30-107",1995,11.1,3,2,0,3,0,0,2,0,2,4,0,4,1,4,10,0,"https://fbref.com/en/players/8eb55dbb/Sheraldo-Becker"
2025,"Real Sociedad","La Liga","Luken Beitia","ESP","DF","20-331",2004,0.1,1,1,1,0,0,1,1,100,0,0,0,0,0,1,2,0,"https://fbref.com/en/players/1406fae0/Luken-Beitia"
2025,"Real Sociedad","La Liga","Daniel Díaz","ESP","MF","18-339",2006,0.1,1,1,1,0,0,0,0,NA,0,1,0,1,0,1,0,0,"https://fbref.com/en/players/423680ee/Daniel-Diaz"
2025,"Real Sociedad","La Liga","Aritz Elustondo","ESP","DF","31-060",1994,16.2,20,11,15,3,2,11,19,57.9,8,17,12,5,11,31,96,0,"https://fbref.com/en/players/f7dc2ae5/Aritz-Elustondo"
2025,"Real Sociedad","La Liga","Sergio Gómez","ESP","MF,DF","24-265",2000,30.4,71,39,30,29,12,30,56,53.6,26,44,3,41,19,90,30,2,"https://fbref.com/en/players/01e5f06e/Sergio-Gomez"
2025,"Real Sociedad","La Liga","Urko González","ESP","MF","24-068",2001,0.5,0,0,0,0,0,0,0,NA,0,1,1,0,0,0,0,0,"https://fbref.com/en/players/c4f5eb61/Urko-Gonzalez"
2025,"Real Sociedad","La Liga","Takefusa Kubo","JPN","MF,FW","23-357",2001,26.4,31,20,11,11,9,16,40,40,24,38,1,37,17,48,13,1,"https://fbref.com/en/players/16aa3654/Takefusa-Kubo"
2025,"Real Sociedad","La Liga","Javi López","ESP","DF","23-063",2002,21.5,40,23,23,12,5,23,37,62.2,14,21,7,14,11,51,59,2,"https://fbref.com/en/players/e9ada8cf/Javi-Lopez"
2025,"Real Sociedad","La Liga","Jon Magunazelaia","ESP","MF","23-318",2001,0.1,1,1,1,0,0,0,0,NA,0,0,0,0,0,1,0,0,"https://fbref.com/en/players/d4808594/Jon-Magunazelaia"
2025,"Real Sociedad","La Liga","Arkaitz Mariezkurrena","ESP","FW,MF","20-052",2005,2.7,1,0,1,0,0,0,4,0,4,4,1,3,1,2,4,0,"https://fbref.com/en/players/7c2c671c/Arkaitz-Mariezkurrena"
2025,"Real Sociedad","La Liga","Pablo Marín","ESP","MF","21-328",2003,13.8,25,17,6,13,6,10,19,52.6,9,12,3,9,5,30,14,0,"https://fbref.com/en/players/a83c19cf/Pablo-Marin"
2025,"Real Sociedad","La Liga","Unai Marrero","ESP","GK","23-230",2001,2,0,0,0,0,0,0,0,NA,0,0,0,0,0,0,1,0,"https://fbref.com/en/players/f0fe87dc/Unai-Marrero"
2025,"Real Sociedad","La Liga","Jon Martin","ESP","DF","19-146",2006,10,11,9,7,3,1,6,9,66.7,3,13,9,4,7,18,80,1,"https://fbref.com/en/players/df33ecb5/Jon-Martin"
2025,"Real Sociedad","La Liga","Brais Méndez","ESP","MF","28-140",1997,17,24,13,6,14,4,9,24,37.5,15,14,1,13,7,31,16,1,"https://fbref.com/en/players/c9e39d91/Brais-Mendez"
2025,"Real Sociedad","La Liga","Aihen Muñoz","ESP","DF","27-284",1997,12.2,24,12,14,8,2,14,28,50,14,11,6,5,14,38,47,0,"https://fbref.com/en/players/228b0d9d/Aihen-Munoz"
2025,"Real Sociedad","La Liga","Álvaro Odriozola","ESP","DF","29-164",1995,0.5,1,1,1,0,0,0,0,NA,0,0,0,0,0,1,1,0,"https://fbref.com/en/players/1d1691ad/Alvaro-Odriozola"
2025,"Real Sociedad","La Liga","Olasagasti","ESP","MF","24-284",2000,9.5,21,10,7,9,5,8,18,44.4,10,8,2,6,15,36,10,0,"https://fbref.com/en/players/3d99999d/Olasagasti"
2025,"Real Sociedad","La Liga","Mikel Oyarzabal","ESP","FW","28-036",1997,25,25,16,9,10,6,10,23,43.5,13,17,1,16,4,29,15,0,"https://fbref.com/en/players/8c3c640c/Mikel-Oyarzabal"
2025,"Real Sociedad","La Liga","Jon Pacheco","ESP","DF","24-139",2001,9.5,15,9,12,3,0,10,12,83.3,2,8,6,2,9,24,49,2,"https://fbref.com/en/players/44150beb/Jon-Pacheco"
2025,"Real Sociedad","La Liga","Álex Remiro","ESP","GK","30-064",1995,36,1,0,1,0,0,1,2,50,1,0,0,0,0,1,18,4,"https://fbref.com/en/players/374ee424/Alex-Remiro"
2025,"Real Sociedad","La Liga","Umar Sadiq","NGA","FW","28-114",1997,2.5,2,1,1,1,0,1,2,50,1,3,1,2,1,3,2,0,"https://fbref.com/en/players/686cbe7d/Umar-Sadiq"
2025,"Real Sociedad","La Liga","Orri Steinn Óskarsson","ISL","FW","20-271",2004,10.5,6,6,2,1,3,2,8,25,6,10,1,9,2,8,11,0,"https://fbref.com/en/players/d0b8e745/Orri-Steinn-Oskarsson"
2025,"Real Sociedad","La Liga","Luka Sučić","CRO","MF","22-261",2002,19.9,25,18,8,12,5,10,26,38.5,16,30,2,28,15,40,16,1,"https://fbref.com/en/players/1e1378e1/Luka-Sucic"
2025,"Real Sociedad","La Liga","Hamari Traoré","MLI","DF","33-120",1992,7.8,19,12,10,7,2,15,22,68.2,7,6,2,4,9,28,21,0,"https://fbref.com/en/players/a4b1028a/Hamari-Traore"
2025,"Real Sociedad","La Liga","Beñat Turrientes","ESP","MF","23-116",2002,10.5,15,6,4,10,1,4,15,26.7,11,15,3,12,5,20,14,1,"https://fbref.com/en/players/068f4dec/Benat-Turrientes"
2025,"Real Sociedad","La Liga","Arsen Zakharyan","RUS","MF,FW","22-001",2003,0.8,1,1,1,0,0,1,1,100,0,1,1,0,1,2,0,0,"https://fbref.com/en/players/7f14ec2a/Arsen-Zakharyan"
2025,"Real Sociedad","La Liga","Igor Zubeldia","ESP","DF","28-058",1997,25.2,34,22,21,10,3,14,26,53.8,12,32,18,14,31,65,100,2,"https://fbref.com/en/players/5c7845f6/Igor-Zubeldia"
2025,"Real Sociedad","La Liga","Martín Zubimendi","ESP","MF","26-114",1999,32.9,73,37,31,29,13,28,44,63.6,16,42,16,26,44,117,79,3,"https://fbref.com/en/players/3ee0dd59/Martin-Zubimendi"
2025,"Reims","Ligue 1","Martin Adeline","FRA","MF","21-176",2003,0.3,1,1,0,1,0,1,2,50,1,0,0,0,0,1,2,0,"https://fbref.com/en/players/7587446d/Martin-Adeline"
2025,"Reims","Ligue 1","Emmanuel Agbadou","CIV","DF","27-344",1997,14,25,17,19,3,3,19,26,73.1,7,22,13,9,19,44,64,1,"https://fbref.com/en/players/75f1ed80/Emmanuel-Agbadou"
2025,"Reims","Ligue 1","Sergio Akieme","ESP","DF","27-162",1997,28,34,23,30,3,1,22,36,61.1,14,26,9,17,17,51,97,4,"https://fbref.com/en/players/06efa9dc/Sergio-Akieme"
2025,"Reims","Ligue 1","Valentin Atangana Edoa","FRA","MF","19-275",2005,31.7,69,50,32,30,7,28,38,73.7,10,31,15,16,37,106,64,0,"https://fbref.com/en/players/6b5edd5d/Valentin-Atangana-Edoa"
2025,"Reims","Ligue 1","Mohamed Bamba","CIV","MF","20-231",2004,0.1,0,0,0,0,0,0,1,0,1,2,1,1,0,0,1,0,"https://fbref.com/en/players/562bf675/Mohamed-Bamba"
2025,"Reims","Ligue 1","Aurélio Buta","POR","DF","28-106",1997,21.9,37,24,22,11,4,21,42,50,21,19,5,14,22,59,59,0,"https://fbref.com/en/players/b4705807/Aurelio-Buta"
2025,"Reims","Ligue 1","Mohamed Daramy","DEN","FW","23-140",2002,0.2,0,0,0,0,0,0,0,NA,0,0,0,0,0,0,1,0,"https://fbref.com/en/players/06a1d642/Mohamed-Daramy"
2025,"Reims","Ligue 1","Thibault De Smet","BEL","DF","26-356",1998,2.1,6,4,5,1,0,4,4,100,0,5,3,2,4,10,12,0,"https://fbref.com/en/players/5fdcb075/Thibault-De-Smet"
2025,"Reims","Ligue 1","Mamadou Diakhon","FRA","FW,MF","19-247",2005,9.5,12,8,4,3,5,9,18,50,9,5,1,4,4,16,5,0,"https://fbref.com/en/players/331c5a98/Mamadou-Diakhon"
2025,"Reims","Ligue 1","Oumar Diakité","CIV","FW","21-158",2003,18.1,20,13,7,8,5,9,19,47.4,10,13,2,11,3,23,9,0,"https://fbref.com/en/players/44435c8f/Oumar-Diakite"
2025,"Reims","Ligue 1","Yehvann Diouf","FRA","GK","25-192",1999,34,2,1,2,0,0,1,3,33.3,2,0,0,0,1,3,22,4,"https://fbref.com/en/players/eedea60b/Yehvann-Diouf"
2025,"Reims","Ligue 1","Mory Gbane","CIV","DF,MF","24-153",2000,12.5,20,11,16,4,0,13,24,54.2,11,12,10,2,18,38,90,1,"https://fbref.com/en/players/ab8b392c/Mory-Gbane"
2025,"Reims","Ligue 1","Hafiz Ibrahim","NGA","FW","19-158",2005,4.3,3,2,0,1,2,0,5,0,5,4,2,2,2,5,6,0,"https://fbref.com/en/players/f4f05099/Hafiz-Ibrahim"
2025,"Reims","Ligue 1","Junya Ito","JPN","FW,MF","32-079",1993,29.9,45,30,19,16,10,17,60,28.3,43,33,3,30,13,58,15,2,"https://fbref.com/en/players/dbd3a428/Junya-Ito"
2025,"Reims","Ligue 1","Malcolm Jeng","SWE","DF","20-079",2005,1.2,0,0,0,0,0,0,0,NA,0,1,0,1,3,3,10,0,"https://fbref.com/en/players/8dbf56c8/Malcolm-Jeng"
2025,"Reims","Ligue 1","John Joe","IRL","MF","21-215",2003,6.1,24,15,11,10,3,7,19,36.8,12,11,2,9,6,30,9,0,"https://fbref.com/en/players/fd01216a/John-Joe"
2025,"Reims","Ligue 1","Yaya Kader Fofana","MLI","MF,FW","20-349",2004,7,17,11,8,5,4,4,12,33.3,8,11,2,9,3,20,2,0,"https://fbref.com/en/players/cedc53d2/Yaya-Kader-Fofana"
2025,"Reims","Ligue 1","Reda Khadra","GER","MF,FW","23-327",2001,0.9,1,1,1,0,0,0,1,0,1,0,0,0,0,1,1,0,"https://fbref.com/en/players/88acf83f/Reda-Khadra"
2025,"Reims","Ligue 1","Cédric Kipré","CIV","DF","28-169",1996,24.3,42,30,30,11,1,29,39,74.4,10,42,27,15,32,74,162,2,"https://fbref.com/en/players/9f30e7ed/Cedric-Kipre"
2025,"Reims","Ligue 1","Abdoul Koné","FRA","DF","20-035",2005,1.5,5,3,4,1,0,3,5,60,2,2,1,1,1,6,5,0,"https://fbref.com/en/players/c1ebf5d2/Abdoul-Kone"
2025,"Reims","Ligue 1","Amadou Koné","MLI","MF","20-013",2005,14.4,49,32,32,16,1,22,35,62.9,13,18,4,14,19,68,38,2,"https://fbref.com/en/players/2eb1ec07/Amadou-Kone"
2025,"Reims","Ligue 1","Ange Martial Tia","MLI","MF,DF","18-188",2006,1.9,4,3,1,2,1,2,6,33.3,4,3,0,3,2,6,4,0,"https://fbref.com/en/players/13579ed2/Ange-Martial-Tia"
2025,"Reims","Ligue 1","Gabriel Moscardo","BRA","MF,DF","19-241",2005,0.9,3,1,2,1,0,1,3,33.3,2,3,1,2,0,3,1,0,"https://fbref.com/en/players/709d3f52/Gabriel-Moscardo"
2025,"Reims","Ligue 1","Marshall Munetsi","ZIM","MF","28-339",1996,18.8,36,18,22,9,5,22,38,57.9,16,27,3,24,17,53,35,0,"https://fbref.com/en/players/2acf0cd7/Marshall-Munetsi"
2025,"Reims","Ligue 1","Keito Nakamura","JPN","FW,MF","24-303",2000,29.4,24,16,7,10,7,11,31,35.5,20,21,1,20,13,37,19,0,"https://fbref.com/en/players/d97af612/Keito-Nakamura"
2025,"Reims","Ligue 1","Joseph Okumu","KEN","DF","28-001",1997,18.8,30,15,21,9,0,15,24,62.5,9,33,21,12,25,55,137,2,"https://fbref.com/en/players/039f1983/Joseph-Okumu"
2025,"Reims","Ligue 1","Ike Orazi","IRL","MF","17-350",2007,0,0,0,0,0,0,0,0,NA,0,0,0,0,0,0,0,0,"https://fbref.com/en/players/60e53ba1/Ike-Orazi"
2025,"Reims","Ligue 1","Jordan Pefok","USA","FW","29-031",1996,4.2,3,2,0,3,0,2,3,66.7,1,3,1,2,2,5,5,0,"https://fbref.com/en/players/b684a484/Jordan-Pefok"
2025,"Reims","Ligue 1","Amine Salama","FRA","FW","24-313",2000,4.1,3,2,0,2,1,0,3,0,3,2,1,1,1,4,0,0,"https://fbref.com/en/players/bc7cc472/Amine-Salama"
2025,"Reims","Ligue 1","Nhoa Sangui","FRA","DF,MF","19-089",2006,12.9,16,9,6,6,4,9,12,75,3,8,4,4,8,24,23,0,"https://fbref.com/en/players/3f465a66/Nhoa-Sangui"
2025,"Reims","Ligue 1","Hiroki Sekine","JPN","DF","22-289",2002,9.9,9,7,6,2,1,7,17,41.2,10,22,11,11,5,14,51,1,"https://fbref.com/en/players/7304dd80/Hiroki-Sekine"
2025,"Reims","Ligue 1","Niama Sissoko","MLI","FW,MF","19-162",2005,0.5,0,0,0,0,0,0,0,NA,0,1,0,1,0,0,0,0,"https://fbref.com/en/players/d349f13b/Niama-Sissoko"
2025,"Reims","Ligue 1","Teddy Teuma","MLT","MF","31-239",1993,8.3,18,10,6,6,6,7,25,28,18,12,2,10,12,30,8,1,"https://fbref.com/en/players/5c26ca51/Teddy-Teuma"
2025,"Reims","Ligue 1","Eloge Zabi","CIV","DF,MF","18-245",2006,0.2,0,0,0,0,0,0,0,NA,0,0,0,0,0,0,1,0,"https://fbref.com/en/players/51438572/Eloge-Zabi"
2025,"Rennes","Ligue 1","Naouirou Ahamada","FRA","MF,FW","23-059",2002,0.6,0,0,0,0,0,0,0,NA,0,0,0,0,2,2,2,0,"https://fbref.com/en/players/a6c58494/Naouirou-Ahamada"
2025,"Rennes","Ligue 1","Lorenz Assignon","TOG","DF,MF","24-339",2000,26.2,49,27,25,22,2,19,43,44.2,24,20,3,17,25,74,74,0,"https://fbref.com/en/players/b026bbf6/Lorenz-Assignon"
2025,"Rennes","Ligue 1","Ludovic Blas","FRA","MF,FW","27-147",1997,25.5,38,25,9,12,17,23,42,54.8,19,16,2,14,13,51,11,0,"https://fbref.com/en/players/6191093d/Ludovic-Blas"
2025,"Rennes","Ligue 1","Benjamin Bourigeaud","FRA","MF","31-133",1994,0.9,1,0,0,1,0,0,2,0,2,2,1,1,2,3,1,0,"https://fbref.com/en/players/20e73fac/Benjamin-Bourigeaud"
2025,"Rennes","Ligue 1","Lilian Brassier","FRA","DF","25-206",1999,13.7,15,12,11,4,0,9,11,81.8,2,17,10,7,22,37,62,1,"https://fbref.com/en/players/5b146df3/Lilian-Brassier"
2025,"Rennes","Ligue 1","Djaoui Cissé","FRA","MF","21-116",2004,12.5,33,18,12,15,6,16,26,61.5,10,29,4,25,13,46,11,1,"https://fbref.com/en/players/576ca93f/Djaoui-Cisse"
2025,"Rennes","Ligue 1","Seko Fofana","CIV","MF","30-020",1995,9.4,11,7,4,6,1,2,7,28.6,5,7,1,6,7,18,7,0,"https://fbref.com/en/players/5313ed43/Seko-Fofana"
2025,"Rennes","Ligue 1","Kyogo Furuhashi","JPN","FW","30-127",1995,1.4,2,2,1,1,0,1,1,100,0,0,0,0,0,2,0,0,"https://fbref.com/en/players/fd4d5f81/Kyogo-Furuhashi"
2025,"Rennes","Ligue 1","Gauthier Gallon","FRA","GK","32-034",1993,0.5,0,0,0,0,0,0,0,NA,0,0,0,0,0,0,0,0,"https://fbref.com/en/players/db3164e1/Gauthier-Gallon"
2025,"Rennes","Ligue 1","Carlos Gómez","COL","MF,DF","22-257",2002,4.2,8,6,3,4,1,3,9,33.3,6,6,0,6,2,10,2,0,"https://fbref.com/en/players/76a82373/Carlos-Gomez"
2025,"Rennes","Ligue 1","Amine Gouiri","ALG","MF,FW","25-100",2000,11.5,9,6,4,4,1,2,8,25,6,8,0,8,2,11,5,0,"https://fbref.com/en/players/aad56ca3/Amine-Gouiri"
2025,"Rennes","Ligue 1","Albert Grønbaek","DEN","MF,FW","24-004",2001,9,21,11,10,7,4,10,28,35.7,18,9,1,8,4,25,6,0,"https://fbref.com/en/players/0da5076f/Albert-Gronbaek"
2025,"Rennes","Ligue 1","Hans Hateboer","NED","DF","31-138",1994,18.7,31,16,14,12,5,18,36,50,18,19,6,13,29,60,64,2,"https://fbref.com/en/players/3b333ac3/Hans-Hateboer"
2025,"Rennes","Ligue 1","Jérémy Jacquet","FRA","DF","19-318",2005,10.3,26,17,11,8,7,14,22,63.6,8,9,3,6,27,53,45,1,"https://fbref.com/en/players/cef70c94/Jeremy-Jacquet"
2025,"Rennes","Ligue 1","Jordan James","WAL","MF","20-329",2004,13.1,30,19,8,18,4,16,30,53.3,14,14,1,13,14,44,17,1,"https://fbref.com/en/players/f719ad7f/Jordan-James"
2025,"Rennes","Ligue 1","Jota","POR","FW,MF","26-058",1999,3.7,5,2,2,3,0,4,7,57.1,3,1,0,1,3,8,2,0,"https://fbref.com/en/players/8c5f1522/Jota"
2025,"Rennes","Ligue 1","Arnaud Kalimuendo","FRA","FW,MF","23-127",2002,28.6,19,12,6,9,4,7,15,46.7,8,9,2,7,4,23,16,1,"https://fbref.com/en/players/bf4c41f9/Arnaud-Kalimuendo"
2025,"Rennes","Ligue 1","Glen Kamara","FIN","MF","29-211",1995,7.4,23,11,10,11,2,11,17,64.7,6,7,0,7,7,30,7,0,"https://fbref.com/en/players/4da9191b/Glen-Kamara"
2025,"Rennes","Ligue 1","Ismaël Koné","CAN","MF","22-355",2002,5.2,9,6,4,4,1,5,7,71.4,2,9,2,7,4,13,5,0,"https://fbref.com/en/players/e0220b70/Ismael-Kone"
2025,"Rennes","Ligue 1","Steve Mandanda","FRA","GK","40-060",1985,16.5,0,0,0,0,0,0,1,0,1,0,0,0,0,0,6,2,"https://fbref.com/en/players/1d2d5cc8/Steve-Mandanda"
2025,"Rennes","Ligue 1","Azor Matusiwa","NED","MF","27-029",1998,23.1,64,39,32,30,2,32,43,74.4,11,29,10,19,34,98,52,0,"https://fbref.com/en/players/a17a94d6/Azor-Matusiwa"
2025,"Rennes","Ligue 1","Henrik Meister","DEN","FW","21-191",2003,0.7,2,0,0,2,0,0,0,NA,0,4,0,4,1,3,0,0,"https://fbref.com/en/players/e1a873eb/Henrik-Meister"
2025,"Rennes","Ligue 1","Mohamed Meité","FRA","FW","17-228",2007,6,2,0,0,2,0,1,1,100,0,1,0,1,0,2,5,0,"https://fbref.com/en/players/424cbbb3/Mohamed-Meite"
2025,"Rennes","Ligue 1","Mahamadou Nagida","CMR","DF","19-333",2005,4.8,8,6,4,3,1,4,5,80,1,3,0,3,9,17,6,0,"https://fbref.com/en/players/8bfbf257/Mahamadou-Nagida"
2025,"Rennes","Ligue 1","Mikayil Ngor Faye","SEN","DF","20-317",2004,7.6,15,12,10,3,2,7,9,77.8,2,9,4,5,12,27,30,0,"https://fbref.com/en/players/b37ae816/Mikayil-Ngor-Faye"
2025,"Rennes","Ligue 1","Kazeem Olaigbe","BEL","MF,FW","22-145",2003,3.3,6,4,3,3,0,3,6,50,3,3,1,2,0,6,0,0,"https://fbref.com/en/players/f3ec7e64/Kazeem-Olaigbe"
2025,"Rennes","Ligue 1","Anthony Rouault","FRA","DF","23-363",2001,10.8,12,8,10,2,0,4,4,100,0,13,11,2,8,20,65,0,"https://fbref.com/en/players/9b545925/Anthony-Rouault"
2025,"Rennes","Ligue 1","Brice Samba","FRA","GK","31-032",1994,17,2,1,2,0,0,1,2,50,1,0,0,0,0,2,12,3,"https://fbref.com/en/players/60d90c55/Brice-Samba"
2025,"Rennes","Ligue 1","Baptiste Santamaria","FRA","MF","30-079",1995,5.4,11,4,7,3,1,6,11,54.5,5,10,4,6,12,23,7,0,"https://fbref.com/en/players/5e22e2a4/Baptiste-Santamaria"
2025,"Rennes","Ligue 1","Alidu Seidu","GHA","DF","24-357",2000,8.9,22,18,14,6,2,12,15,80,3,13,6,7,14,36,17,0,"https://fbref.com/en/players/cea59f02/Alidu-Seidu"
2025,"Rennes","Ligue 1","Ayanda Sishuba","BEL","FW","20-114",2005,0,1,0,1,0,0,1,1,100,0,0,0,0,0,1,0,0,"https://fbref.com/en/players/6fd76804/Ayanda-Sishuba"
2025,"Rennes","Ligue 1","Leo Skiri Østigård","NOR","DF","25-180",1999,13.6,20,18,16,4,0,15,22,68.2,7,12,10,2,15,35,81,1,"https://fbref.com/en/players/b35a7399/Leo-Skiri-Ostigard"
2025,"Rennes","Ligue 1","Musa Al-Taamari","JOR","FW,MF","27-351",1997,6.3,4,1,1,1,2,0,4,0,4,5,0,5,2,6,2,0,"https://fbref.com/en/players/f15f8b2b/Musa-Al-Taamari"
2025,"Rennes","Ligue 1","Adrien Truffert","FRA","DF,MF","23-188",2001,30.6,61,36,27,21,13,32,48,66.7,16,44,6,38,27,88,56,1,"https://fbref.com/en/players/5d0e0a1f/Adrien-Truffert"
2025,"Rennes","Ligue 1","Christopher Wooh","CMR","DF","23-251",2001,16.2,36,19,21,13,2,18,27,66.7,9,22,8,14,23,59,63,0,"https://fbref.com/en/players/b003239d/Christopher-Wooh"
2025,"Roma","Serie A","Saud Abdulhamid","KSA","DF","25-313",1999,2.3,3,2,2,0,1,1,1,100,0,2,0,2,2,5,0,0,"https://fbref.com/en/players/caa254e4/Saud-Abdulhamid"
2025,"Roma","Serie A","Tammy Abraham","ENG","FW","27-237",1997,0,0,0,0,0,0,0,1,0,1,0,0,0,0,0,0,0,"https://fbref.com/en/players/f586779e/Tammy-Abraham"
2025,"Roma","Serie A","Angeliño","ESP","DF","28-143",1997,35.3,46,24,20,24,2,17,34,50,17,33,9,24,28,74,98,0,"https://fbref.com/en/players/30941e96/Angelino"
2025,"Roma","Serie A","Tommaso Baldanzi","ITA","MF,FW","22-065",2003,9.2,12,4,5,4,3,4,12,33.3,8,4,0,4,6,18,8,0,"https://fbref.com/en/players/102e2599/Tommaso-Baldanzi"
2025,"Roma","Serie A","Zeki Çelik","TUR","DF","28-099",1997,25.1,62,37,21,31,10,23,43,53.5,20,28,9,19,15,77,84,3,"https://fbref.com/en/players/31a62dc7/Zeki-Celik"
2025,"Roma","Serie A","Bryan Cristante","ITA","MF","30-085",1995,22.7,48,29,18,24,6,15,26,57.7,11,20,10,10,19,67,36,1,"https://fbref.com/en/players/16657b95/Bryan-Cristante"
2025,"Roma","Serie A","Samuel Dahl","SWE","DF,MF","25-084",2000,0.5,2,2,0,2,0,1,2,50,1,2,0,2,0,2,0,0,"https://fbref.com/en/players/bbe7d20b/Samuel-Dahl"
2025,"Roma","Serie A","Artem Dovbyk","UKR","FW","27-340",1997,26.9,4,2,0,1,3,0,4,0,4,10,3,7,2,6,12,0,"https://fbref.com/en/players/5b847bb0/Artem-Dovbyk"
2025,"Roma","Serie A","Paulo Dybala","ARG","FW,MF","31-193",1993,15.7,17,7,3,9,5,8,19,42.1,11,12,1,11,2,19,2,0,"https://fbref.com/en/players/e0921a4f/Paulo-Dybala"
2025,"Roma","Serie A","Lucas Gourna-Douath","FRA","MF","21-295",2003,2.5,9,4,5,4,0,2,6,33.3,4,1,1,0,0,9,2,0,"https://fbref.com/en/players/3cd7820a/Lucas-Gourna-Douath"
2025,"Roma","Serie A","Mario Hermoso","ESP","DF","29-343",1995,2.8,2,1,2,0,0,0,1,0,1,1,1,0,4,6,13,0,"https://fbref.com/en/players/555f3a0b/Mario-Hermoso"
2025,"Roma","Serie A","Mats Hummels","GER","DF","36-162",1988,10.2,30,15,16,14,0,11,18,61.1,7,12,4,8,26,56,43,0,"https://fbref.com/en/players/05d548d8/Mats-Hummels"
2025,"Roma","Serie A","Manu Koné","FRA","MF","24-010",2001,28.6,41,26,17,17,7,19,40,47.5,21,27,4,23,24,65,28,0,"https://fbref.com/en/players/86574238/Manu-Kone"
2025,"Roma","Serie A","Enzo Le Fée","FRA","MF","25-113",2000,3.5,7,4,5,2,0,2,6,33.3,4,9,3,6,5,12,2,0,"https://fbref.com/en/players/6f806d99/Enzo-Le-Fee"
2025,"Roma","Serie A","Gianluca Mancini","ITA","DF","29-040",1996,34.9,42,26,22,18,2,20,34,58.8,14,22,16,6,35,77,103,0,"https://fbref.com/en/players/5aa53281/Gianluca-Mancini"
2025,"Roma","Serie A","Obite N'Dicka","CIV","DF","25-280",1999,38,32,26,17,15,0,14,21,66.7,7,46,30,16,33,65,150,2,"https://fbref.com/en/players/441197b8/Obite-NDicka"
2025,"Roma","Serie A","Victor Nelsson","DEN","DF","26-225",1998,2.1,5,4,3,1,1,3,5,60,2,1,0,1,2,7,9,0,"https://fbref.com/en/players/e53b5534/Victor-Nelsson"
2025,"Roma","Serie A","Leandro Paredes","ARG","MF","30-332",1994,15.3,26,14,9,12,5,16,32,50,16,14,5,9,19,45,33,2,"https://fbref.com/en/players/dff153a4/Leandro-Paredes"
2025,"Roma","Serie A","Lorenzo Pellegrini","ITA","MF","28-342",1996,18.1,24,16,5,13,6,8,19,42.1,11,8,1,7,6,30,22,0,"https://fbref.com/en/players/4a5a45c7/Lorenzo-Pellegrini"
2025,"Roma","Serie A","Niccolò Pisilli","ITA","MF","20-246",2004,13.6,24,11,11,8,5,12,22,54.5,10,14,3,11,11,35,16,0,"https://fbref.com/en/players/c84dcc88/Niccolo-Pisilli"
2025,"Roma","Serie A","Devyne Rensch","NED","DF","22-129",2003,5.2,17,13,8,8,1,9,10,90,1,5,3,2,7,24,12,1,"https://fbref.com/en/players/c5cbbcff/Devyne-Rensch"
2025,"Roma","Serie A","Alexis Saelemaekers","BEL","DF,FW","25-334",1999,15.4,33,20,22,7,4,18,35,51.4,17,12,1,11,9,42,8,1,"https://fbref.com/en/players/ee251371/Alexis-Saelemaekers"
2025,"Roma","Serie A","Anass Salah-Eddine","NED","DF","23-129",2002,1.7,1,1,1,0,0,0,0,NA,0,0,0,0,1,2,2,2,"https://fbref.com/en/players/0d274394/Anass-Salah-Eddine"
2025,"Roma","Serie A","Stephan El Shaarawy","ITA","DF,MF","32-212",1992,12.2,16,12,4,6,6,6,12,50,6,4,0,4,10,26,13,0,"https://fbref.com/en/players/d3aaad90/Stephan-El-Shaarawy"
2025,"Roma","Serie A","Eldor Shomurodov","UZB","FW,MF","29-332",1995,12.2,14,6,2,7,5,3,6,50,3,10,1,9,3,17,5,0,"https://fbref.com/en/players/57469b2d/Eldor-Shomurodov"
2025,"Roma","Serie A","Matìas Soulé","ARG","MF,DF","22-042",2003,19.8,26,16,12,7,7,10,23,43.5,13,25,3,22,9,35,25,0,"https://fbref.com/en/players/c13ddd3e/Matias-Soule"
2025,"Roma","Serie A","Mile Svilar","SRB","GK","25-273",1999,38,0,0,0,0,0,0,0,NA,0,0,0,0,0,0,12,2,"https://fbref.com/en/players/bcf5058a/Mile-Svilar"
2025,"Roma","Serie A","Nicola Zalewski","POL","DF,FW","23-124",2002,5.9,8,6,3,2,3,2,7,28.6,5,7,2,5,4,12,8,2,"https://fbref.com/en/players/45191c29/Nicola-Zalewski"
2025,"Saint-Étienne","Ligue 1","Yunis Abdelhamid","MAR","DF","37-241",1987,11.5,17,11,15,2,0,10,16,62.5,6,26,18,8,14,31,57,1,"https://fbref.com/en/players/32c2d95f/Yunis-Abdelhamid"
2025,"Saint-Étienne","Ligue 1","Ayman Aiki","FRA","FW,MF","19-336",2005,1.4,3,3,1,2,0,1,1,100,0,1,0,1,1,4,0,0,"https://fbref.com/en/players/8399c416/Ayman-Aiki"
2025,"Saint-Étienne","Ligue 1","Mathis Amougou","FRA","MF","19-129",2006,9.5,21,15,15,5,1,10,19,52.6,9,10,0,10,12,33,4,0,"https://fbref.com/en/players/f93cca97/Mathis-Amougou"
2025,"Saint-Étienne","Ligue 1","Dennis Appiah","FRA","DF","32-352",1992,23.6,71,43,42,22,7,41,71,57.7,30,36,8,28,29,100,89,2,"https://fbref.com/en/players/feb5d3ab/Dennis-Appiah"
2025,"Saint-Étienne","Ligue 1","Dylan Batubinsika","COD","DF","29-101",1996,22.4,26,13,19,6,1,13,22,59.1,9,23,14,9,39,65,140,3,"https://fbref.com/en/players/37d39918/Dylan-Batubinsika"
2025,"Saint-Étienne","Ligue 1","Maxime Bernauer","FRA","DF","26-330",1998,8.5,9,9,5,2,2,5,8,62.5,3,7,3,4,5,14,44,1,"https://fbref.com/en/players/43750e5d/Maxime-Bernauer"
2025,"Saint-Étienne","Ligue 1","Augustine Boakye","GHA","FW,MF","24-205",2000,8.1,7,3,3,4,0,3,11,27.3,8,5,0,5,6,13,4,0,"https://fbref.com/en/players/59e9edb5/Augustine-Boakye"
2025,"Saint-Étienne","Ligue 1","Benjamin Bouchouari","MAR","MF","23-195",2001,19.7,33,27,15,13,5,16,46,34.8,30,21,1,20,17,50,15,2,"https://fbref.com/en/players/599f9013/Benjamin-Bouchouari"
2025,"Saint-Étienne","Ligue 1","Anthony Briançon","FRA","DF","30-180",1994,0,0,0,0,0,0,0,0,NA,0,0,0,0,0,0,0,0,"https://fbref.com/en/players/16324e1d/Anthony-Briancon"
2025,"Saint-Étienne","Ligue 1","Mathieu Cafaro","FRA","MF,FW","28-063",1997,8.1,10,7,4,4,2,4,15,26.7,11,7,1,6,7,17,3,0,"https://fbref.com/en/players/2a657da0/Mathieu-Cafaro"
2025,"Saint-Étienne","Ligue 1","Irvin Cardona","FRA","FW","27-292",1997,11.8,6,5,3,3,0,2,14,14.3,12,16,3,13,4,10,6,2,"https://fbref.com/en/players/5e080f73/Irvin-Cardona"
2025,"Saint-Étienne","Ligue 1","Pierre Cornud","FRA","DF","28-166",1996,6.4,12,10,6,4,2,8,17,47.1,9,9,4,5,9,21,28,1,"https://fbref.com/en/players/edeb21ff/Pierre-Cornud"
2025,"Saint-Étienne","Ligue 1","Zuriko Davitashvili","GEO","FW,MF","24-101",2001,30.9,22,14,9,7,6,15,49,30.6,34,20,0,20,14,36,14,0,"https://fbref.com/en/players/88b4d2e3/Zuriko-Davitashvili"
2025,"Saint-Étienne","Ligue 1","Pierre Ekwah Elimby","FRA","MF","23-132",2002,28.6,54,33,18,30,6,34,56,60.7,22,26,12,14,47,101,72,1,"https://fbref.com/en/players/830371be/Pierre-Ekwah-Elimby"
2025,"Saint-Étienne","Ligue 1","Lamine Fomba","FRA","MF","27-121",1998,2.4,8,6,2,5,1,2,7,28.6,5,7,1,6,4,12,5,1,"https://fbref.com/en/players/2145368f/Lamine-Fomba"
2025,"Saint-Étienne","Ligue 1","Gautier Larsonneur","FRA","GK","28-093",1997,34,1,0,1,0,0,0,2,0,2,1,0,1,0,1,25,1,"https://fbref.com/en/players/b49729cb/Gautier-Larsonneur"
2025,"Saint-Étienne","Ligue 1","Yvann Macon","FRA","DF","26-238",1998,8.8,19,11,9,7,3,10,21,47.6,11,14,4,10,2,21,10,1,"https://fbref.com/en/players/0bb6e193/Yvann-Macon"
2025,"Saint-Étienne","Ligue 1","Igor Miladinović","SRB","FW,MF","21-353",2003,0.3,0,0,0,0,0,0,0,NA,0,0,0,0,1,1,1,0,"https://fbref.com/en/players/3ba938b6/Igor-Miladinovic"
2025,"Saint-Étienne","Ligue 1","Aimen Moueffek","FRA","MF","24-048",2001,11.5,20,12,3,11,6,10,23,43.5,13,20,7,13,5,25,26,1,"https://fbref.com/en/players/2591b066/Aimen-Moueffek"
2025,"Saint-Étienne","Ligue 1","Louis Mouton","FRA","MF","22-358",2002,11.6,49,25,14,25,10,22,37,59.5,15,17,3,14,10,59,19,0,"https://fbref.com/en/players/c37823fe/Louis-Mouton"
2025,"Saint-Étienne","Ligue 1","Djylian N'Guessan","FRA","FW","16-270",2008,2,6,4,5,1,0,2,5,40,3,1,0,1,0,6,1,0,"https://fbref.com/en/players/63b27fab/Djylian-NGuessan"
2025,"Saint-Étienne","Ligue 1","Mickael Nade","FRA","DF","26-084",1999,25.6,59,43,40,19,0,28,36,77.8,8,37,19,18,33,92,132,8,"https://fbref.com/en/players/a6b6fa6e/Mickael-Nade"
2025,"Saint-Étienne","Ligue 1","Marwann Nzuzi","FRA","DF","21-011",2004,1.4,2,2,1,0,1,1,2,50,1,0,0,0,2,4,6,0,"https://fbref.com/en/players/165787d9/Marwann-Nzuzi"
2025,"Saint-Étienne","Ligue 1","Ben Old","NZL","FW,MF","22-287",2002,5.9,7,5,3,3,1,3,11,27.3,8,8,1,7,2,9,2,0,"https://fbref.com/en/players/e14e818c/Ben-Old"
2025,"Saint-Étienne","Ligue 1","Jibril Othman","TUN","FW","21-031",2004,0.1,0,0,0,0,0,0,0,NA,0,0,0,0,0,0,0,0,"https://fbref.com/en/players/967bb460/Jibril-Othman"
2025,"Saint-Étienne","Ligue 1","Beres Owusu","FRA","DF","21-250",2003,1,2,2,1,1,0,2,2,100,0,2,2,0,0,2,5,0,"https://fbref.com/en/players/32c61db3/Beres-Owusu"
2025,"Saint-Étienne","Ligue 1","Kévin Pedro","FRA","DF","19-095",2006,0.1,3,0,2,1,0,3,3,100,0,1,0,1,2,5,1,0,"https://fbref.com/en/players/ff1f24ca/Kevin-Pedro"
2025,"Saint-Étienne","Ligue 1","Léo Pétrot","FRA","DF","28-042",1997,29.3,62,39,38,19,5,34,51,66.7,17,50,27,23,42,104,103,1,"https://fbref.com/en/players/00638016/Leo-Petrot"
2025,"Saint-Étienne","Ligue 1","Ibrahim Sissoko","MLI","FW","29-181",1995,9.1,11,9,5,3,3,2,5,40,3,10,2,8,2,13,13,0,"https://fbref.com/en/players/a170541f/Ibrahim-Sissoko"
2025,"Saint-Étienne","Ligue 1","Lucas Stassin","BEL","FW","20-180",2004,21,16,11,3,5,8,6,20,30,14,10,0,10,3,19,8,0,"https://fbref.com/en/players/a47d6f3a/Lucas-Stassin"
2025,"Saint-Étienne","Ligue 1","Florian Tardieu","FRA","MF","33-035",1992,13.9,18,14,6,9,3,6,17,35.3,11,18,5,13,15,33,21,0,"https://fbref.com/en/players/ed39121c/Florian-Tardieu"
2025,"Saint-Étienne","Ligue 1","Ibrahima Wadji","SEN","FW,MF","30-022",1995,3.9,7,6,3,3,1,3,7,42.9,4,1,0,1,1,8,0,0,"https://fbref.com/en/players/c844f6f9/Ibrahima-Wadji"
2025,"Sevilla","La Liga","Akor Adams","NGA","FW","25-118",2000,1.5,0,0,0,0,0,0,0,NA,0,1,0,1,0,0,1,0,"https://fbref.com/en/players/2ccd39ed/Akor-Adams"
2025,"Sevilla","La Liga","Lucien Agoume","FRA","MF","23-107",2002,23.5,70,32,23,37,10,27,39,69.2,12,30,11,19,41,111,42,0,"https://fbref.com/en/players/8bc8829a/Lucien-Agoume"
2025,"Sevilla","La Liga","Leandro Antonetti","PUR","FW","22-134",2003,0.3,0,0,0,0,0,0,0,NA,0,0,0,0,0,0,0,0,"https://fbref.com/en/players/2febb559/Leandro-Antonetti"
2025,"Sevilla","La Liga","Loïc Bade","FRA","DF","25-046",2000,29.8,47,27,37,10,0,23,31,74.2,8,22,13,9,29,76,162,2,"https://fbref.com/en/players/114bbdee/Loic-Bade"
2025,"Sevilla","La Liga","Valentín Barco","ARG","DF,FW","20-308",2004,3.2,15,9,8,3,4,12,15,80,3,0,0,0,2,17,5,0,"https://fbref.com/en/players/b9f282ec/Valentin-Barco"
2025,"Sevilla","La Liga","Manu Bueno","ESP","MF,FW","20-304",2004,1.6,4,3,0,1,3,1,2,50,1,0,0,0,0,4,2,0,"https://fbref.com/en/players/c5642098/Manu-Bueno"
2025,"Sevilla","La Liga","Carmona","ESP","DF","23-118",2002,32.7,83,59,53,21,9,41,77,53.2,36,37,11,26,68,151,92,3,"https://fbref.com/en/players/2dce876a/Carmona"
2025,"Sevilla","La Liga","Israel Domínguez","ESP","FW","22-020",2003,0.2,0,0,0,0,0,0,0,NA,0,0,0,0,0,0,0,0,"https://fbref.com/en/players/d2ba7592/Israel-Dominguez"
2025,"Sevilla","La Liga","Chidera Ejuke","NGA","FW","27-145",1998,10.7,19,13,8,9,2,9,20,45,11,12,0,12,5,24,8,0,"https://fbref.com/en/players/e7f3e8a7/Chidera-Ejuke"
2025,"Sevilla","La Liga","Álvaro Fernández","ESP","GK","27-044",1998,8.3,0,0,0,0,0,0,1,0,1,0,0,0,0,0,7,0,"https://fbref.com/en/players/f127d782/Alvaro-Fernandez"
2025,"Sevilla","La Liga","Darío Fuentes","ESP","DF","22-135",2003,0.1,0,0,0,0,0,0,0,NA,0,0,0,0,0,0,0,0,"https://fbref.com/en/players/893268ab/Dario-Fuentes"
2025,"Sevilla","La Liga","Nemanja Gudelj","SRB","MF,DF","33-192",1991,27.7,42,24,16,22,4,21,35,60,14,27,10,17,27,69,94,1,"https://fbref.com/en/players/0076ab7f/Nemanja-Gudelj"
2025,"Sevilla","La Liga","Stanis Idumbo","BEL","FW,MF","19-332",2005,3.2,9,5,3,4,2,3,5,60,2,3,1,2,4,13,2,0,"https://fbref.com/en/players/53551b98/Stanis-Idumbo"
2025,"Sevilla","La Liga","Kelechi Iheanacho","NGA","FW","28-236",1996,4.4,1,0,0,1,0,1,3,33.3,2,0,0,0,0,1,1,0,"https://fbref.com/en/players/c92e1a31/Kelechi-Iheanacho"
2025,"Sevilla","La Liga","Diego Iturralde","ESP","FW","22-041",2003,0.4,0,0,0,0,0,0,0,NA,0,0,0,0,1,1,1,0,"https://fbref.com/en/players/9d33c71a/Diego-Iturralde"
2025,"Sevilla","La Liga","Dodi Lukebakio","BEL","FW","27-245",1997,34.4,22,14,8,8,6,15,27,55.6,12,18,1,17,11,33,17,2,"https://fbref.com/en/players/0c61c77c/Dodi-Lukebakio"
2025,"Sevilla","La Liga","Marcão","BRA","DF","28-356",1996,6.1,10,7,6,4,0,3,5,60,2,9,6,3,7,17,29,1,"https://fbref.com/en/players/133faa84/Marcao"
2025,"Sevilla","La Liga","Ramón Martínez","ESP","DF","22-217",2002,2.9,6,3,5,1,0,3,5,60,2,2,1,1,2,8,23,0,"https://fbref.com/en/players/a04f40c8/Ramon-Martinez"
2025,"Sevilla","La Liga","Mateo Mejía","ESP","FW","22-057",2003,0.1,0,0,0,0,0,0,0,NA,0,0,0,0,0,0,0,0,"https://fbref.com/en/players/a96e9b5c/Mateo-Mejia"
2025,"Sevilla","La Liga","Gonzalo Montiel","ARG","DF,MF","28-146",1997,1.3,4,2,3,1,0,3,4,75,1,0,0,0,2,6,11,0,"https://fbref.com/en/players/374d5158/Gonzalo-Montiel"
2025,"Sevilla","La Liga","Jesús Navas","ESP","FW,MF","39-187",1985,4.7,5,2,3,0,2,0,3,0,3,1,0,1,4,9,6,0,"https://fbref.com/en/players/3f10bd22/Jesus-Navas"
2025,"Sevilla","La Liga","Tanguy Nianzou","FRA","DF","22-354",2002,5.8,7,5,6,0,1,5,6,83.3,1,1,0,1,8,15,27,0,"https://fbref.com/en/players/5853ac44/Tanguy-Nianzou"
2025,"Sevilla","La Liga","Saúl Ñíguez","ESP","MF","30-187",1994,17.3,47,32,16,24,7,12,31,38.7,19,25,2,23,22,69,34,0,"https://fbref.com/en/players/c14bc029/Saul-Niguez"
2025,"Sevilla","La Liga","Ørjan Nyland","NOR","GK","34-259",1990,29.7,3,2,3,0,0,3,5,60,2,0,0,0,0,3,12,4,"https://fbref.com/en/players/bdedffac/Orjan-Nyland"
2025,"Sevilla","La Liga","Lucas Ocampos","ARG","FW","30-320",1994,1.9,3,2,2,0,1,1,2,50,1,2,0,2,0,3,2,0,"https://fbref.com/en/players/a08b974a/Lucas-Ocampos"
2025,"Sevilla","La Liga","Álvaro Pascual","ESP","FW","23-146",2002,4.5,1,3,0,0,1,1,2,50,1,0,0,0,2,3,0,0,"https://fbref.com/en/players/68ad2350/Alvaro-Pascual"
2025,"Sevilla","La Liga","Adrià Pedrosa","ESP","DF","27-014",1998,25.5,56,32,34,16,6,31,54,57.4,23,43,11,32,24,80,85,0,"https://fbref.com/en/players/112521d1/Adria-Pedrosa"
2025,"Sevilla","La Liga","Peque","ESP","MF,FW","22-235",2002,12.6,16,5,4,10,2,7,17,41.2,10,16,0,16,8,24,5,0,"https://fbref.com/en/players/cb971b4f/Peque"
2025,"Sevilla","La Liga","Isaac Romero","ESP","FW","25-009",2000,24,13,7,4,4,5,3,16,18.8,13,18,1,17,7,20,27,0,"https://fbref.com/en/players/be719093/Isaac-Romero"
2025,"Sevilla","La Liga","Kike Salas","ESP","DF","23-034",2002,24.9,47,28,24,16,7,27,46,58.7,19,26,14,12,32,79,146,0,"https://fbref.com/en/players/0a69de7b/Kike-Salas"
2025,"Sevilla","La Liga","Albert Sambi Lokonga","BEL","MF","25-217",1999,16.3,22,15,10,9,3,10,14,71.4,4,13,1,12,9,31,24,3,"https://fbref.com/en/players/1b4f1169/Albert-Sambi-Lokonga"
2025,"Sevilla","La Liga","Juanlu Sánchez","ESP","MF,DF","21-285",2003,19.1,50,34,28,15,7,35,59,59.3,24,27,2,25,17,67,19,0,"https://fbref.com/en/players/cc6de655/Juanlu-Sanchez"
2025,"Sevilla","La Liga","Djibril Sow","SUI","MF","28-110",1997,22.9,25,14,13,10,2,8,17,47.1,9,18,3,15,28,53,26,1,"https://fbref.com/en/players/4c6facae/Djibril-Sow"
2025,"Sevilla","La Liga","Suso","ESP","FW,MF","31-189",1993,6.7,10,7,3,6,1,4,11,36.4,7,4,0,4,4,14,2,0,"https://fbref.com/en/players/4e219ad2/Suso"
2025,"Sevilla","La Liga","Ruben Vargas","SUI","FW,MF","26-295",1998,7.5,7,4,1,5,1,3,8,37.5,5,9,0,9,3,10,10,0,"https://fbref.com/en/players/6ecbddf6/Ruben-Vargas"
2025,"Southampton","Premier League","Carlos Alcaraz","ARG","MF","22-178",2002,0.1,0,0,0,0,0,0,0,NA,0,0,0,0,1,1,0,0,"https://fbref.com/en/players/4abac767/Carlos-Alcaraz"
2025,"Southampton","Premier League","Samuel Amo-Ameyaw","ENG","FW,DF","18-313",2006,0.3,1,0,0,1,0,1,1,100,0,0,0,0,0,1,0,0,"https://fbref.com/en/players/9eedf0e0/Samuel-Amo-Ameyaw"
2025,"Southampton","Premier League","Cameron Archer","ENG","FW","23-310",2001,16,13,8,8,3,2,2,9,22.2,7,5,1,4,2,15,11,0,"https://fbref.com/en/players/05e8ca6d/Cameron-Archer"
2025,"Southampton","Premier League","Joe Aribo","NGA","MF,DF","28-310",1996,22.4,47,33,17,24,6,17,35,48.6,18,28,11,17,20,67,32,3,"https://fbref.com/en/players/328f7d51/Joe-Aribo"
2025,"Southampton","Premier League","Adam Armstrong","ENG","FW,MF","28-106",1997,13.9,12,3,2,7,3,3,14,21.4,11,6,1,5,3,15,8,0,"https://fbref.com/en/players/68c720b5/Adam-Armstrong"
2025,"Southampton","Premier League","Jan Bednarek","POL","DF","29-045",1996,28.1,36,19,23,13,0,16,31,51.6,15,47,36,11,56,92,190,5,"https://fbref.com/en/players/4115ce4e/Jan-Bednarek"
2025,"Southampton","Premier League","Armel Bella Kotchap","GER","DF","23-167",2001,3.7,7,5,5,2,0,3,6,50,3,2,2,0,5,12,21,1,"https://fbref.com/en/players/a39d11bc/Armel-Bella-Kotchap"
2025,"Southampton","Premier League","James Bree","ENG","DF","27-228",1997,11.9,19,14,8,10,1,10,25,40,15,10,3,7,9,28,29,0,"https://fbref.com/en/players/c07b7c5c/James-Bree"
2025,"Southampton","Premier League","Ben Brereton","CHI","FW","26-039",1999,5,3,2,0,2,1,1,9,11.1,8,2,1,1,0,3,4,0,"https://fbref.com/en/players/57827369/Ben-Brereton"
2025,"Southampton","Premier League","Maxwel Cornet","CIV","FW","28-242",1996,0.8,5,5,1,4,0,0,4,0,4,0,0,0,0,5,2,0,"https://fbref.com/en/players/beb391dd/Maxwel-Cornet"
2025,"Southampton","Premier League","Tyler Dibling","ENG","FW,MF","19-076",2006,20.8,34,20,13,18,3,16,26,61.5,10,19,5,14,8,42,16,1,"https://fbref.com/en/players/bdcc89ae/Tyler-Dibling"
2025,"Southampton","Premier League","Flynn Downes","ENG","MF","26-127",1999,23.9,49,25,23,21,5,15,36,41.7,21,28,9,19,32,81,51,4,"https://fbref.com/en/players/69fdb896/Flynn-Downes"
2025,"Southampton","Premier League","Samuel Edozie","ENG","DF,FW","22-119",2003,0.7,3,1,0,1,2,2,2,100,0,0,0,0,0,3,0,0,"https://fbref.com/en/players/007414dd/Samuel-Edozie"
2025,"Southampton","Premier League","Ronnie Edwards","ENG","DF","22-060",2003,0.1,0,0,0,0,0,0,0,NA,0,1,1,0,0,0,0,0,"https://fbref.com/en/players/be90c4b0/Ronnie-Edwards"
2025,"Southampton","Premier League","Mateus Fernandes","POR","MF","20-321",2004,32.3,89,48,45,28,16,33,72,45.8,39,43,8,35,28,117,35,7,"https://fbref.com/en/players/ef491564/Mateus-Fernandes"
2025,"Southampton","Premier League","Ryan Fraser","SCO","FW,DF","31-092",1994,3.4,6,2,2,4,0,4,6,66.7,2,1,1,0,1,7,9,0,"https://fbref.com/en/players/d56543a0/Ryan-Fraser"
2025,"Southampton","Premier League","Albert Grønbaek","DEN","FW,MF","24-004",2001,1.6,4,1,1,1,2,3,10,30,7,1,1,0,0,4,1,0,"https://fbref.com/en/players/0da5076f/Albert-Gronbaek"
2025,"Southampton","Premier League","Taylor Harwood-Bellis","ENG","DF","23-117",2002,31.4,28,20,13,12,3,19,35,54.3,16,65,43,22,30,58,141,6,"https://fbref.com/en/players/47327321/Taylor-Harwood-Bellis"
2025,"Southampton","Premier League","Joachim Kayi Sanda","FRA","DF","18-179",2006,0.2,0,0,0,0,0,0,0,NA,0,0,0,0,2,2,0,0,"https://fbref.com/en/players/e2b2a181/Joachim-Kayi-Sanda"
2025,"Southampton","Premier League","Adam Lallana","ENG","MF","37-017",1988,4,8,5,4,4,0,2,12,16.7,10,4,1,3,5,13,5,0,"https://fbref.com/en/players/99813635/Adam-Lallana"
2025,"Southampton","Premier League","Joe Lumley","ENG","GK","30-101",1995,3,0,0,0,0,0,0,0,NA,0,0,0,0,0,0,3,3,"https://fbref.com/en/players/bdf3a08e/Joe-Lumley"
2025,"Southampton","Premier League","Ryan Manning","IRL","DF,MF","28-347",1996,16.2,28,17,16,10,2,14,26,53.8,12,20,11,9,17,45,47,0,"https://fbref.com/en/players/847b53eb/Ryan-Manning"
2025,"Southampton","Premier League","Alex McCarthy","ENG","GK","35-175",1989,5,0,0,0,0,0,0,0,NA,0,0,0,0,0,0,1,4,"https://fbref.com/en/players/36c2ca73/Alex-McCarthy"
2025,"Southampton","Premier League","Paul Onuachu","NGA","FW","30-364",1994,11.7,7,2,1,5,1,3,7,42.9,4,7,2,5,1,8,16,1,"https://fbref.com/en/players/c06d1086/Paul-Onuachu"
2025,"Southampton","Premier League","Aaron Ramsdale","ENG","GK","27-013",1998,30,0,0,0,0,0,0,3,0,3,0,0,0,2,2,10,3,"https://fbref.com/en/players/466fb2c5/Aaron-Ramsdale"
2025,"Southampton","Premier League","Jay Robinson","ENG","MF,FW","18-073",2007,1.5,4,1,3,0,1,1,1,100,0,0,0,0,0,4,1,0,"https://fbref.com/en/players/2a616c85/Jay-Robinson"
2025,"Southampton","Premier League","William Smallbone","IRL","MF","25-095",2000,7.7,20,13,9,9,2,7,22,31.8,15,8,0,8,2,22,14,2,"https://fbref.com/en/players/5e105217/William-Smallbone"
2025,"Southampton","Premier League","Jack Stephens","ENG","DF","31-120",1994,15.4,34,20,25,9,0,17,30,56.7,13,20,13,7,13,47,53,2,"https://fbref.com/en/players/6adbc307/Jack-Stephens"
2025,"Southampton","Premier League","Ross Stewart","SCO","FW","28-320",1996,4.3,6,4,1,1,4,3,8,37.5,5,3,0,3,1,7,7,0,"https://fbref.com/en/players/18986367/Ross-Stewart"
2025,"Southampton","Premier League","Yukinari Sugawara","JPN","DF,MF","24-333",2000,17.3,31,18,16,14,1,19,31,61.3,12,21,10,11,11,42,53,3,"https://fbref.com/en/players/580bcd18/Yukinari-Sugawara"
2025,"Southampton","Premier League","Kamaldeen Sulemana","GHA","FW,MF","23-101",2002,15.6,22,17,9,5,8,10,15,66.7,5,16,4,12,6,28,9,0,"https://fbref.com/en/players/a62f8bf1/Kamaldeen-Sulemana"
2025,"Southampton","Premier League","Charlie Taylor","ENG","DF","31-251",1993,4,7,5,4,3,0,5,7,71.4,2,8,5,3,5,12,31,1,"https://fbref.com/en/players/cc2d7ad5/Charlie-Taylor"
2025,"Southampton","Premier League","Lesley Ugochukwu","FRA","MF","21-062",2004,18.4,50,24,16,30,4,18,36,50,18,27,10,17,14,64,23,2,"https://fbref.com/en/players/1df4a109/Lesley-Ugochukwu"
2025,"Southampton","Premier League","Kyle Walker-Peters","ENG","DF","28-044",1997,32.4,44,29,22,15,7,16,35,45.7,19,27,15,12,19,63,90,1,"https://fbref.com/en/players/984a5a64/Kyle-Walker-Peters"
2025,"Southampton","Premier League","Welington","BRA","DF","24-097",2001,5.4,21,9,15,5,1,12,19,63.2,7,5,1,4,7,28,36,0,"https://fbref.com/en/players/a7f95b1f/Welington"
2025,"Southampton","Premier League","Nathan Wood-Gordon","ENG","DF","22-361",2002,8.6,14,8,8,5,1,8,11,72.7,3,9,6,3,5,19,39,2,"https://fbref.com/en/players/4ccf2d5b/Nathan-Wood-Gordon"
2025,"St. Pauli","Bundesliga","Oladapo Afolayan","ENG","FW,MF","27-104",1998,18.2,17,8,4,8,5,7,19,36.8,12,17,1,16,8,25,20,0,"https://fbref.com/en/players/5054c359/Oladapo-Afolayan"
2025,"St. Pauli","Bundesliga","Erik Ahlstrand","SWE","FW,MF","23-225",2001,0.5,0,0,0,0,0,0,0,NA,0,1,0,1,1,1,1,0,"https://fbref.com/en/players/f6b692c0/Erik-Ahlstrand"
2025,"St. Pauli","Bundesliga","Andreas Albers","DEN","FW","35-065",1990,0.7,1,1,0,0,1,0,1,0,1,0,0,0,0,1,1,0,"https://fbref.com/en/players/94471fb7/Andreas-Albers"
2025,"St. Pauli","Bundesliga","Ben Alexander Voll","GER","GK","24-169",2000,1,0,0,0,0,0,0,0,NA,0,0,0,0,0,0,0,0,"https://fbref.com/en/players/ee8ad906/Ben-Alexander-Voll"
2025,"St. Pauli","Bundesliga","Scott Banks","SCO","FW,MF","23-243",2001,1.3,1,1,1,0,0,0,2,0,2,0,0,0,2,3,2,0,"https://fbref.com/en/players/d01f8942/Scott-Banks"
2025,"St. Pauli","Bundesliga","Carlo Boukhalfa","MAR","MF","26-024",1999,18.3,26,11,7,17,2,7,19,36.8,12,22,3,19,12,38,25,1,"https://fbref.com/en/players/1a86f4a9/Carlo-Boukhalfa"
2025,"St. Pauli","Bundesliga","Abdoulie Ceesay","GAM","FW","21-142",2004,0.7,3,3,1,1,1,2,3,66.7,1,2,0,2,0,3,1,0,"https://fbref.com/en/players/72ae8652/Abdoulie-Ceesay"
2025,"St. Pauli","Bundesliga","Adam Dźwigała","POL","DF,MF","29-244",1995,4.1,20,10,13,6,1,11,16,68.8,5,6,1,5,4,24,28,0,"https://fbref.com/en/players/75edc8ce/Adam-Dzwigala"
2025,"St. Pauli","Bundesliga","Johannes Eggestein","GER","FW","27-019",1998,20.6,5,3,0,2,3,1,5,20,4,5,0,5,0,5,8,0,"https://fbref.com/en/players/d571df78/Johannes-Eggestein"
2025,"St. Pauli","Bundesliga","Morgan Guilavogui","GUI","FW,MF","27-078",1998,20.1,32,17,11,16,5,14,31,45.2,17,28,0,28,13,45,33,0,"https://fbref.com/en/players/79b51257/Morgan-Guilavogui"
2025,"St. Pauli","Bundesliga","Jackson Irvine","AUS","MF","32-081",1993,29,56,28,24,26,6,25,45,55.6,20,27,5,22,36,92,63,2,"https://fbref.com/en/players/4637747c/Jackson-Irvine"
2025,"St. Pauli","Bundesliga","Maurides","BRA","FW","31-078",1994,0,0,0,0,0,0,0,0,NA,0,0,0,0,0,0,0,0,"https://fbref.com/en/players/b0e50531/Maurides"
2025,"St. Pauli","Bundesliga","Connor Metcalfe","AUS","MF,FW","25-203",1999,4,2,0,1,1,0,0,5,0,5,4,0,4,3,5,8,0,"https://fbref.com/en/players/73ce4d7d/Connor-Metcalfe"
2025,"St. Pauli","Bundesliga","Karol Mets","EST","DF","32-011",1993,10,13,8,6,7,0,4,7,57.1,3,9,3,6,12,25,60,0,"https://fbref.com/en/players/ef2ad14e/Karol-Mets"
2025,"St. Pauli","Bundesliga","David Nemeth","AUT","DF","24-070",2001,23.7,43,29,25,16,2,25,43,58.1,18,29,11,18,18,61,94,2,"https://fbref.com/en/players/da76715c/David-Nemeth"
2025,"St. Pauli","Bundesliga","Lars Ritzka","GER","DF,MF","27-020",1998,10.2,49,29,28,16,5,25,41,61,16,16,2,14,11,60,41,0,"https://fbref.com/en/players/35d23b15/Lars-Ritzka"
2025,"St. Pauli","Bundesliga","Elias Saad","TUN","FW,MF","25-151",1999,10,20,13,7,8,5,10,20,50,10,14,0,14,3,23,1,0,"https://fbref.com/en/players/78a2284f/Elias-Saad"
2025,"St. Pauli","Bundesliga","Manolis Saliakas","GRE","MF,DF","28-257",1996,25.7,46,22,24,18,4,25,49,51,24,38,8,30,20,66,62,0,"https://fbref.com/en/players/18fe6d90/Manolis-Saliakas"
2025,"St. Pauli","Bundesliga","James Sands","USA","MF,DF","24-325",2000,5,15,6,5,8,2,4,4,100,0,5,1,4,5,20,8,0,"https://fbref.com/en/players/dccd127f/James-Sands"
2025,"St. Pauli","Bundesliga","Danel Sinani","LUX","FW,MF","28-052",1997,13.9,14,11,2,7,5,6,14,42.9,8,12,1,11,1,15,13,0,"https://fbref.com/en/players/96ddfa79/Danel-Sinani"
2025,"St. Pauli","Bundesliga","Eric Smith","SWE","DF,MF","28-139",1997,31.4,46,29,26,17,3,23,40,57.5,17,37,10,27,37,83,104,4,"https://fbref.com/en/players/8817312f/Eric-Smith"
2025,"St. Pauli","Bundesliga","Finley Stevens","WAL","DF","22-047",2003,0,0,0,0,0,0,0,0,NA,0,0,0,0,0,0,0,0,"https://fbref.com/en/players/7e003182/Finley-Stevens"
2025,"St. Pauli","Bundesliga","Philipp Treu","GER","MF,DF","24-175",2000,32,61,42,35,17,9,39,68,57.4,29,52,12,40,19,80,87,2,"https://fbref.com/en/players/047822ad/Philipp-Treu"
2025,"St. Pauli","Bundesliga","Siebe Van Der Heyden","BEL","DF,MF","26-362",1998,9.7,17,10,10,7,0,8,18,44.4,10,8,4,4,17,34,43,2,"https://fbref.com/en/players/cf9bdd43/Siebe-Van-Der-Heyden"
2025,"St. Pauli","Bundesliga","Nikola Vasilj","BIH","GK","29-176",1995,33,0,0,0,0,0,0,2,0,2,0,0,0,0,0,22,3,"https://fbref.com/en/players/f038585f/Nikola-Vasilj"
2025,"St. Pauli","Bundesliga","Robert Wagner","GER","MF","21-317",2003,4.5,8,3,2,6,0,4,13,30.8,9,8,0,8,2,10,12,0,"https://fbref.com/en/players/e3d3fbeb/Robert-Wagner"
2025,"St. Pauli","Bundesliga","Hauke Wahl","GER","DF","31-042",1994,33,36,27,21,13,2,23,38,60.5,15,44,25,19,31,67,170,4,"https://fbref.com/en/players/f3db5b34/Hauke-Wahl"
2025,"St. Pauli","Bundesliga","Noah Weißhaupt","GER","FW,MF","23-249",2001,12.9,6,4,3,0,3,3,8,37.5,5,7,0,7,2,8,8,1,"https://fbref.com/en/players/dd676a97/Noah-Weisshaupt"
2025,"Strasbourg","Ligue 1","Samuel Amo-Ameyaw","ENG","DF,MF","18-313",2006,3.6,5,3,3,2,0,2,9,22.2,7,3,0,3,3,8,2,0,"https://fbref.com/en/players/9eedf0e0/Samuel-Amo-Ameyaw"
2025,"Strasbourg","Ligue 1","Dilane Bakwa","FRA","MF,DF","22-274",2002,27.7,26,14,11,8,7,12,24,50,12,21,1,20,15,41,27,0,"https://fbref.com/en/players/2b5a35e5/Dilane-Bakwa"
2025,"Strasbourg","Ligue 1","Valentín Barco","ARG","MF,DF","20-308",2004,12.9,36,22,24,10,2,22,30,73.3,8,8,3,5,13,49,28,1,"https://fbref.com/en/players/b9f282ec/Valentin-Barco"
2025,"Strasbourg","Ligue 1","Pape Daouda Diongue","SEN","MF,FW","",NA,0.9,2,0,1,1,0,1,2,50,1,0,0,0,3,5,2,0,"https://fbref.com/en/players/d4925a40/Pape-Daouda-Diongue"
2025,"Strasbourg","Ligue 1","Thomas Delaine","FRA","DF","33-064",1992,0.1,1,1,1,0,0,1,1,100,0,0,0,0,1,2,1,0,"https://fbref.com/en/players/8332db56/Thomas-Delaine"
2025,"Strasbourg","Ligue 1","Habib Diarra","SEN","MF,FW","21-144",2004,26.1,22,13,6,13,3,8,20,40,12,22,6,16,13,35,46,3,"https://fbref.com/en/players/6d0fe035/Habib-Diarra"
2025,"Strasbourg","Ligue 1","Guela Doué","CIV","DF","22-222",2002,30.2,65,45,40,15,10,37,54,68.5,17,38,6,32,34,99,154,1,"https://fbref.com/en/players/b4ef3fb5/Guela-Doue"
2025,"Strasbourg","Ligue 1","Ismaël Doukouré","FRA","DF,MF","21-307",2003,29.3,40,22,19,18,3,17,25,68,8,31,14,17,25,65,102,3,"https://fbref.com/en/players/0512a60a/Ismael-Doukoure"
2025,"Strasbourg","Ligue 1","Emanuel Emegha","NED","FW","22-113",2003,25.5,6,6,1,2,3,2,6,33.3,4,18,5,13,1,7,30,0,"https://fbref.com/en/players/a0c590b9/Emanuel-Emegha"
2025,"Strasbourg","Ligue 1","Karol Fila","POL","MF","26-348",1998,0.1,0,0,0,0,0,0,0,NA,0,0,0,0,0,0,0,0,"https://fbref.com/en/players/50ac8941/Karol-Fila"
2025,"Strasbourg","Ligue 1","Karl-Johan Johnsson","SWE","GK","35-119",1990,3,0,0,0,0,0,0,1,0,1,0,0,0,0,0,3,0,"https://fbref.com/en/players/a56bd2ee/Karl-Johan-Johnsson"
2025,"Strasbourg","Ligue 1","Nordine Kandil","FRA","MF","23-208",2001,0.1,0,0,0,0,0,0,0,NA,0,0,0,0,0,0,1,0,"https://fbref.com/en/players/c5908bc4/Nordine-Kandil"
2025,"Strasbourg","Ligue 1","Félix Lemaréchal","FRA","MF,FW","21-293",2003,19.8,35,24,13,17,5,14,29,48.3,15,35,4,31,14,49,19,0,"https://fbref.com/en/players/8ca9415f/Felix-Lemarechal"
2025,"Strasbourg","Ligue 1","Milos Lukovic","SRB","FW,MF","19-190",2005,0.1,0,0,0,0,0,0,0,NA,0,0,0,0,0,0,0,0,"https://fbref.com/en/players/b1c7a35e/Milos-Lukovic"
2025,"Strasbourg","Ligue 1","Sekou Mara","FRA","FW,MF","22-301",2002,8.5,9,6,0,5,4,3,9,33.3,6,11,0,11,3,12,3,0,"https://fbref.com/en/players/3544641e/Sekou-Mara"
2025,"Strasbourg","Ligue 1","Diego Moreira","POR","DF,MF","20-294",2004,28.5,44,28,17,19,8,24,50,48,26,23,4,19,35,79,65,0,"https://fbref.com/en/players/12de1b0d/Diego-Moreira"
2025,"Strasbourg","Ligue 1","Junior Mwanga","FRA","MF","22-016",2003,3.3,17,9,9,7,1,5,9,55.6,4,2,0,2,2,19,2,0,"https://fbref.com/en/players/ee158be5/Junior-Mwanga"
2025,"Strasbourg","Ligue 1","Sebastian Nanasi","SWE","MF,FW","23-011",2002,23.4,20,13,6,12,2,8,22,36.4,14,24,3,21,7,27,18,0,"https://fbref.com/en/players/ce747d2a/Sebastian-Nanasi"
2025,"Strasbourg","Ligue 1","Andrew Omobamidele","IRL","DF","22-338",2002,6,7,4,4,3,0,2,5,40,3,12,8,4,8,15,41,0,"https://fbref.com/en/players/c393a6c4/Andrew-Omobamidele"
2025,"Strasbourg","Ligue 1","Guimissongui Ouattara","FRA","DF,FW","19-217",2005,5.2,6,4,3,1,2,3,5,60,2,10,0,10,9,15,12,2,"https://fbref.com/en/players/d028b5e5/Guimissongui-Ouattara"
2025,"Strasbourg","Ligue 1","Óscar Perea","COL","MF,DF","19-242",2005,0.2,0,0,0,0,0,0,0,NA,0,0,0,0,0,0,0,0,"https://fbref.com/en/players/57bc72ea/Oscar-Perea"
2025,"Strasbourg","Ligue 1","Đorđe Petrović","SRB","GK","25-231",1999,31,1,1,1,0,0,0,0,NA,0,0,0,0,0,1,24,1,"https://fbref.com/en/players/0cf321c8/Djordje-Petrovic"
2025,"Strasbourg","Ligue 1","Andrey Santos","BRA","MF","21-024",2004,31.7,110,74,47,51,12,51,87,58.6,36,46,14,32,32,142,67,1,"https://fbref.com/en/players/dd745366/Andrey-Santos"
2025,"Strasbourg","Ligue 1","Mamadou Sarr","FRA","DF","19-271",2005,26.3,37,21,24,11,2,16,24,66.7,8,26,20,6,25,62,117,3,"https://fbref.com/en/players/61f80c89/Mamadou-Sarr"
2025,"Strasbourg","Ligue 1","Jérémy Sebas","MTQ","FW,MF","22-043",2003,2.1,3,2,1,1,1,2,3,66.7,1,2,0,2,0,3,4,0,"https://fbref.com/en/players/0b6911e4/Jeremy-Sebas"
2025,"Strasbourg","Ligue 1","Marvin Senaya","TOG","DF","24-119",2001,2.5,8,3,5,2,1,6,12,50,6,6,2,4,7,15,12,0,"https://fbref.com/en/players/1d383c10/Marvin-Senaya"
2025,"Strasbourg","Ligue 1","Eduard Sobol","UKR","DF","30-037",1995,1.1,0,0,0,0,0,0,2,0,2,2,1,1,2,2,14,0,"https://fbref.com/en/players/2ccd89a3/Eduard-Sobol"
2025,"Strasbourg","Ligue 1","Saidou Sow","GUI","DF","22-327",2002,11.3,9,5,6,3,0,6,12,50,6,15,9,6,15,24,37,2,"https://fbref.com/en/players/f6b94e8d/Saidou-Sow"
2025,"Strasbourg","Ligue 1","Abakar Sylla","CIV","DF","22-153",2002,10.6,27,15,14,11,2,15,17,88.2,2,18,10,8,11,38,63,0,"https://fbref.com/en/players/29c91632/Abakar-Sylla"
2025,"Strasbourg","Ligue 1","Caleb Wiley","USA","DF,MF","20-156",2004,3,1,0,0,1,0,0,1,0,1,3,1,2,4,5,5,0,"https://fbref.com/en/players/64796fe0/Caleb-Wiley"
2025,"Stuttgart","Bundesliga","El Bilal Touré","MLI","FW,MF","23-236",2001,4,4,1,1,1,2,3,3,100,0,1,0,1,0,4,1,0,"https://fbref.com/en/players/47c609d5/El-Bilal-Toure"
2025,"Stuttgart","Bundesliga","Jacob Bruun Larsen","DEN","MF,FW","26-250",1998,4.6,1,1,1,0,0,0,2,0,2,7,0,7,1,2,4,1,"https://fbref.com/en/players/4e204552/Jacob-Bruun-Larsen"
2025,"Stuttgart","Bundesliga","Julian Chabot","GER","DF","27-104",1998,25.2,37,24,19,15,3,15,32,46.9,17,29,19,10,38,75,135,0,"https://fbref.com/en/players/ae7058f9/Julian-Chabot"
2025,"Stuttgart","Bundesliga","Anrie Chase","JPN","DF","21-064",2004,8.2,10,4,6,4,0,5,7,71.4,2,10,6,4,9,19,35,0,"https://fbref.com/en/players/ee2cf168/Anrie-Chase"
2025,"Stuttgart","Bundesliga","Ameen Al-Dakhil","BEL","DF","23-082",2002,4.8,6,6,4,2,0,4,4,100,0,12,8,4,9,15,30,1,"https://fbref.com/en/players/93e08bce/Ameen-Al-Dakhil"
2025,"Stuttgart","Bundesliga","Ermedin Demirović","BIH","FW","27-063",1998,20.6,12,7,3,4,5,3,12,25,9,14,3,11,3,15,12,0,"https://fbref.com/en/players/ed79b7d3/Ermedin-Demirovic"
2025,"Stuttgart","Bundesliga","Justin Diehl","GER","FW,DF","20-181",2004,1.2,1,0,0,1,0,1,1,100,0,2,0,2,0,1,0,0,"https://fbref.com/en/players/d82a310a/Justin-Diehl"
2025,"Stuttgart","Bundesliga","Chris Führich","GER","MF,FW","27-138",1998,22,15,10,5,5,5,13,27,48.1,14,23,2,21,6,21,19,0,"https://fbref.com/en/players/0cf778df/Chris-Fuhrich"
2025,"Stuttgart","Bundesliga","Ramon Hendriks","NED","DF","23-313",2001,12.8,20,9,11,7,2,9,13,69.2,4,15,7,8,19,39,63,0,"https://fbref.com/en/players/5a28ad23/Ramon-Hendriks"
2025,"Stuttgart","Bundesliga","Luca Jaquez","SUI","DF","21-359",2003,2.8,3,0,3,0,0,1,3,33.3,2,2,0,2,3,6,4,0,"https://fbref.com/en/players/a400da8e/Luca-Jaquez"
2025,"Stuttgart","Bundesliga","Finn Jeltsch","GER","DF","18-314",2006,8.7,18,13,6,11,1,12,15,80,3,12,6,6,13,31,27,2,"https://fbref.com/en/players/227c9f36/Finn-Jeltsch"
2025,"Stuttgart","Bundesliga","Atakan Karazor","","MF","28-226",1996,29.1,59,29,19,28,12,29,57,50.9,28,39,7,32,32,91,51,1,"https://fbref.com/en/players/5762be5c/Atakan-Karazor"
2025,"Stuttgart","Bundesliga","Yannik Keitel","GER","MF","25-101",2000,3,9,6,3,5,1,9,10,90,1,5,2,3,4,13,6,0,"https://fbref.com/en/players/d2c580ce/Yannik-Keitel"
2025,"Stuttgart","Bundesliga","Frans Krätzig","GER","DF","22-133",2003,0.6,2,1,1,0,1,1,3,33.3,2,2,1,1,0,2,1,0,"https://fbref.com/en/players/1fc08838/Frans-Kratzig"
2025,"Stuttgart","Bundesliga","Jamie Leweling","GER","MF,FW","24-090",2001,18.5,16,6,6,3,7,11,25,44,14,22,1,21,11,27,17,1,"https://fbref.com/en/players/13fe7b69/Jamie-Leweling"
2025,"Stuttgart","Bundesliga","Jarzinho Malanga","GER","DF","18-321",2006,0,0,0,0,0,0,0,0,NA,0,0,0,0,0,0,0,0,"https://fbref.com/en/players/d17b4d71/Jarzinho-Malanga"
2025,"Stuttgart","Bundesliga","Enzo Millot","FRA","MF,FW","22-314",2002,20.5,30,13,10,15,5,12,35,34.3,23,27,0,27,13,43,6,1,"https://fbref.com/en/players/f76022e7/Enzo-Millot"
2025,"Stuttgart","Bundesliga","Maximilian Mittelstädt","GER","DF","28-070",1997,27.4,79,54,42,30,7,53,73,72.6,20,47,11,36,47,126,96,2,"https://fbref.com/en/players/88d4144a/Maximilian-Mittelstadt"
2025,"Stuttgart","Bundesliga","Nikolas Nartey","DEN","MF","25-094",2000,0.2,0,0,0,0,0,0,0,NA,0,0,0,0,0,0,4,0,"https://fbref.com/en/players/30261ba1/Nikolas-Nartey"
2025,"Stuttgart","Bundesliga","Alexander Nübel","GER","GK","28-239",1996,34,0,0,0,0,0,0,1,0,1,0,0,0,0,0,18,3,"https://fbref.com/en/players/afb0c500/Alexander-Nubel"
2025,"Stuttgart","Bundesliga","Fabian Rieder","SUI","MF,FW","23-100",2002,9.6,17,14,4,9,4,7,23,30.4,16,10,1,9,10,27,7,1,"https://fbref.com/en/players/c2bd8585/Fabian-Rieder"
2025,"Stuttgart","Bundesliga","Anthony Rouault","FRA","DF","23-363",2001,13.5,15,11,10,3,2,10,15,66.7,5,18,9,9,19,34,63,1,"https://fbref.com/en/players/9b545925/Anthony-Rouault"
2025,"Stuttgart","Bundesliga","Pascal Stenzel","GER","DF","29-068",1996,3.2,3,2,1,0,2,2,5,40,3,5,1,4,2,5,6,0,"https://fbref.com/en/players/99f7e9aa/Pascal-Stenzel"
2025,"Stuttgart","Bundesliga","Leonidas Stergiou","SUI","DF","23-085",2002,9.5,24,13,9,11,4,16,19,84.2,3,16,5,11,14,38,39,0,"https://fbref.com/en/players/08391d76/Leonidas-Stergiou"
2025,"Stuttgart","Bundesliga","Angelo Stiller","GER","MF","24-053",2001,30.5,49,27,18,25,6,14,30,46.7,16,29,9,20,26,75,50,4,"https://fbref.com/en/players/3b1ed320/Angelo-Stiller"
2025,"Stuttgart","Bundesliga","Deniz Undav","GER","FW,MF","28-312",1996,19.2,11,10,2,3,6,1,17,5.9,16,15,2,13,3,14,10,0,"https://fbref.com/en/players/dd549382/Deniz-Undav"
2025,"Stuttgart","Bundesliga","Josha Vagnoman","GER","DF,MF","24-167",2000,20.4,26,14,11,13,2,17,34,50,17,16,2,14,14,40,57,1,"https://fbref.com/en/players/fb377d11/Josha-Vagnoman"
2025,"Stuttgart","Bundesliga","Nick Woltemade","GER","FW,MF","23-102",2002,18,10,7,2,4,4,6,10,60,4,23,2,21,1,11,15,1,"https://fbref.com/en/players/7ca196eb/Nick-Woltemade"
2025,"Stuttgart","Bundesliga","Dan-Axel Zagadou","FRA","DF,MF","25-358",1999,0.3,0,0,0,0,0,0,0,NA,0,0,0,0,1,1,1,0,"https://fbref.com/en/players/a4effc55/Dan-Axel-Zagadou"
2025,"Torino","Serie A","Che Adams","SCO","FW","28-318",1996,29.5,12,6,2,4,6,1,7,14.3,6,13,6,7,2,14,18,0,"https://fbref.com/en/players/f2bf1b0f/Che-Adams"
2025,"Torino","Serie A","Raoul Bellanova","ITA","DF","25-010",2000,1,0,0,0,0,0,0,1,0,1,0,0,0,0,0,4,0,"https://fbref.com/en/players/e3756e72/Raoul-Bellanova"
2025,"Torino","Serie A","Cristiano Biraghi","ITA","DF","32-268",1992,12.9,16,10,9,3,4,11,18,61.1,7,15,4,11,8,24,44,0,"https://fbref.com/en/players/9e1577aa/Cristiano-Biraghi"
2025,"Torino","Serie A","Alessio Cacciamani","ITA","MF,DF","17-332",2007,0.3,0,0,0,0,0,0,0,NA,0,0,0,0,1,1,0,0,"https://fbref.com/en/players/2028c5c3/Alessio-Cacciamani"
2025,"Torino","Serie A","Cesare Casadei","ITA","MF","22-137",2003,11.3,12,5,4,8,0,5,10,50,5,4,2,2,5,17,26,0,"https://fbref.com/en/players/fb920f3a/Cesare-Casadei"
2025,"Torino","Serie A","Aaron Ciammaglichella","ITA","MF","20-121",2005,0,0,0,0,0,0,0,0,NA,0,0,0,0,0,0,0,0,"https://fbref.com/en/players/20525799/Aaron-Ciammaglichella"
2025,"Torino","Serie A","Saúl Coco","EQG","DF","26-107",1999,31.6,46,26,31,14,1,19,30,63.3,11,49,31,18,38,84,157,4,"https://fbref.com/en/players/d0ee1652/Saul-Coco"
2025,"Torino","Serie A","Ali Dembélé","FRA","DF","21-142",2004,4.3,9,5,6,3,0,4,4,100,0,6,2,4,1,10,11,1,"https://fbref.com/en/players/eb3df7d9/Ali-Dembele"
2025,"Torino","Serie A","Elif Elmas","MKD","FW,MF","25-245",1999,11.3,10,7,3,5,2,4,10,40,6,8,2,6,6,16,5,2,"https://fbref.com/en/players/cf007308/Elif-Elmas"
2025,"Torino","Serie A","Tommaso Gabellini","ITA","FW","18-218",2006,0.1,0,0,0,0,0,0,0,NA,0,0,0,0,0,0,0,0,"https://fbref.com/en/players/2c105080/Tommaso-Gabellini"
2025,"Torino","Serie A","Gvidas Gineitis","LTU","MF","21-042",2004,15.9,25,15,8,10,7,13,25,52,12,16,6,10,18,43,32,0,"https://fbref.com/en/players/548bd0de/Gvidas-Gineitis"
2025,"Torino","Serie A","Ivan Ilić","SRB","MF","24-071",2001,10.2,5,2,0,4,1,2,8,25,6,0,0,0,5,10,10,0,"https://fbref.com/en/players/bb376bed/Ivan-Ilic"
2025,"Torino","Serie A","Yann Karamoh","FRA","MF,FW","26-323",1998,11.6,5,2,2,1,2,4,9,44.4,5,10,2,8,3,8,5,0,"https://fbref.com/en/players/8b66d9cc/Yann-Karamoh"
2025,"Torino","Serie A","Valentino Lazaro","AUT","DF,FW","29-064",1996,25.6,26,12,10,12,4,15,30,50,15,28,5,23,11,37,38,1,"https://fbref.com/en/players/016ff750/Valentino-Lazaro"
2025,"Torino","Serie A","Karol Linetty","POL","MF","30-114",1995,17.1,39,23,17,19,3,20,41,48.8,21,14,5,9,12,51,31,1,"https://fbref.com/en/players/d023d70f/Karol-Linetty"
2025,"Torino","Serie A","Guillermo Maripán","CHI","DF","31-021",1994,26,40,23,25,14,1,21,33,63.6,12,27,13,14,41,81,138,1,"https://fbref.com/en/players/d9764034/Guillermo-Maripan"
2025,"Torino","Serie A","Adam Masina","MAR","DF","31-145",1994,21.3,33,15,22,10,1,23,40,57.5,17,28,15,13,27,60,95,2,"https://fbref.com/en/players/de0f152c/Adam-Masina"
2025,"Torino","Serie A","Vanja Milinković-Savić","SRB","GK","28-096",1997,37,1,0,1,0,0,1,3,33.3,2,0,0,0,0,1,18,4,"https://fbref.com/en/players/9fa26bc2/Vanja-Milinkovic-Savic"
2025,"Torino","Serie A","Eybi Nije","SWE","FW,MF","20-013",2005,4.4,5,1,3,1,1,0,3,0,3,5,1,4,0,5,1,0,"https://fbref.com/en/players/15918c9c/Eybi-Nije"
2025,"Torino","Serie A","Alberto Paleari","ITA","GK","32-271",1992,1,0,0,0,0,0,0,0,NA,0,0,0,0,0,0,2,0,"https://fbref.com/en/players/94a3606c/Alberto-Paleari"
2025,"Torino","Serie A","Marcus Pedersen","NOR","DF","24-315",2000,15.1,13,8,6,6,1,10,16,62.5,6,11,2,9,13,26,34,1,"https://fbref.com/en/players/596cc50e/Marcus-Pedersen"
2025,"Torino","Serie A","Sergiu Perciun","MDA","FW,MF","19-034",2006,1.7,2,2,0,0,2,1,4,25,3,2,0,2,1,3,2,0,"https://fbref.com/en/players/21929f91/Sergiu-Perciun"
2025,"Torino","Serie A","Samuele Ricci","ITA","MF","23-279",2001,31.4,35,21,15,14,6,18,28,64.3,10,23,9,14,25,60,51,2,"https://fbref.com/en/players/9823be92/Samuele-Ricci"
2025,"Torino","Serie A","Antonio Sanabria","PAR","FW","29-084",1996,14.6,3,3,1,1,1,1,4,25,3,6,1,5,1,4,13,0,"https://fbref.com/en/players/0a447501/Antonio-Sanabria"
2025,"Torino","Serie A","Saba Sazonov","GEO","DF","23-115",2002,0,0,0,0,0,0,0,0,NA,0,1,1,0,0,0,0,0,"https://fbref.com/en/players/645dffbf/Saba-Sazonov"
2025,"Torino","Serie A","Borna Sosa","CRO","DF","27-126",1998,13.1,26,19,14,7,5,16,25,64,9,13,6,7,14,40,33,0,"https://fbref.com/en/players/af0d79a9/Borna-Sosa"
2025,"Torino","Serie A","Adrien Tameze","CMR","MF,DF","31-112",1994,7.2,5,2,2,3,0,1,10,10,9,8,5,3,10,15,8,1,"https://fbref.com/en/players/8da74c05/Adrien-Tameze"
2025,"Torino","Serie A","Nikola Vlašić","CRO","MF,FW","27-235",1997,23.5,37,19,11,17,9,12,30,40,18,15,3,12,9,46,15,0,"https://fbref.com/en/players/aa8e289e/Nikola-Vlasic"
2025,"Torino","Serie A","Mërgim Vojvoda","KVX","DF","30-115",1995,12.3,18,10,5,9,4,7,14,50,7,13,3,10,7,25,24,1,"https://fbref.com/en/players/be2706c0/Mergim-Vojvoda"
2025,"Torino","Serie A","Sebastian Walukiewicz","POL","DF","25-052",2000,18.5,38,20,18,16,4,23,31,74.2,8,21,8,13,18,56,60,0,"https://fbref.com/en/players/217875a4/Sebastian-Walukiewicz"
2025,"Torino","Serie A","Duván Zapata","COL","FW","34-056",1991,6.5,7,5,2,0,5,0,3,0,3,2,1,1,2,9,7,0,"https://fbref.com/en/players/d3de9af0/Duvan-Zapata"
2025,"Tottenham","Premier League","Brandon Austin","ENG","GK","26-139",1999,1,0,0,0,0,0,0,0,NA,0,0,0,0,0,0,1,0,"https://fbref.com/en/players/5e253986/Brandon-Austin"
2025,"Tottenham","Premier League","Rodrigo Bentancur","URU","MF","27-336",1997,18.3,40,22,19,17,4,19,40,47.5,21,25,8,17,40,80,38,1,"https://fbref.com/en/players/3b8674e6/Rodrigo-Bentancur"
2025,"Tottenham","Premier League","Lucas Bergvall","SWE","MF","19-114",2006,13.5,39,19,14,20,5,17,32,53.1,15,18,8,10,24,63,22,3,"https://fbref.com/en/players/a109e5c8/Lucas-Bergvall"
2025,"Tottenham","Premier League","Yves Bissouma","MLI","MF","28-270",1996,15.6,49,31,20,25,4,19,34,55.9,15,11,6,5,18,67,40,4,"https://fbref.com/en/players/6c203af0/Yves-Bissouma"
2025,"Tottenham","Premier League","Kevin Danso","AUT","DF","26-250",1998,9.4,7,5,4,3,0,6,11,54.5,5,15,14,1,6,13,71,1,"https://fbref.com/en/players/6e33125f/Kevin-Danso"
2025,"Tottenham","Premier League","Ben Davies","WAL","DF","32-033",1993,14.8,17,11,8,8,1,9,17,52.9,8,28,19,9,12,29,81,1,"https://fbref.com/en/players/44781702/Ben-Davies"
2025,"Tottenham","Premier League","Alfie Dorrington","ENG","DF","20-037",2005,0.2,0,0,0,0,0,0,0,NA,0,0,0,0,0,0,0,0,"https://fbref.com/en/players/ac1ef440/Alfie-Dorrington"
2025,"Tottenham","Premier League","Radu Drăgușin","ROU","DF","23-113",2002,13.9,10,6,8,2,0,6,12,50,6,22,16,6,15,25,49,4,"https://fbref.com/en/players/620922ed/Radu-Dragusin"
2025,"Tottenham","Premier League","Fraser Forster","ENG","GK","37-071",1988,7,0,0,0,0,0,0,1,0,1,0,0,0,0,0,7,3,"https://fbref.com/en/players/c3e39f12/Fraser-Forster"
2025,"Tottenham","Premier League","Archie Gray","ENG","DF,MF","19-076",2006,19.5,16,8,4,8,4,7,17,41.2,10,22,11,11,19,35,50,2,"https://fbref.com/en/players/f58515f5/Archie-Gray"
2025,"Tottenham","Premier League","Son Heung-min","KOR","FW","32-323",1992,23.4,17,9,3,8,6,5,27,18.5,22,11,0,11,5,22,17,1,"https://fbref.com/en/players/92e7e919/Son-Heung-min"
2025,"Tottenham","Premier League","Brennan Johnson","WAL","FW","24-004",2001,24.2,39,26,9,20,10,16,34,47.1,18,25,3,22,4,43,14,0,"https://fbref.com/en/players/0cd31129/Brennan-Johnson"
2025,"Tottenham","Premier League","Antonín Kinský","CZE","GK","22-075",2003,6,3,1,3,0,0,1,1,100,0,0,0,0,0,3,9,1,"https://fbref.com/en/players/b38ac6a4/Antonin-Kinsky"
2025,"Tottenham","Premier League","Dejan Kulusevski","SWE","MF,FW","25-032",2000,26.5,45,23,17,13,15,19,51,37.3,32,34,5,29,13,58,10,1,"https://fbref.com/en/players/df3cda47/Dejan-Kulusevski"
2025,"Tottenham","Premier League","Will Lankshear","ENG","FW,MF","20-037",2005,0.1,0,0,0,0,0,0,0,NA,0,0,0,0,0,0,0,0,"https://fbref.com/en/players/92df535b/Will-Lankshear"
2025,"Tottenham","Premier League","James Maddison","ENG","MF","28-185",1996,20.1,31,19,8,16,7,9,29,31,20,15,4,11,12,43,19,1,"https://fbref.com/en/players/ee38d9c5/James-Maddison"
2025,"Tottenham","Premier League","Pape Matar Sarr","SEN","MF","22-255",2002,21.3,49,36,19,23,7,12,24,50,12,26,10,16,30,79,25,1,"https://fbref.com/en/players/feb5d972/Pape-Matar-Sarr"
2025,"Tottenham","Premier League","Mikey Moore","ENG","FW","17-289",2007,4.1,2,1,2,0,0,0,4,0,4,2,0,2,1,3,5,0,"https://fbref.com/en/players/00953a9d/Mikey-Moore"
2025,"Tottenham","Premier League","Wilson Odobert","FRA","FW,MF","20-180",2004,9.4,14,5,5,4,5,8,14,57.1,6,6,0,6,4,18,5,1,"https://fbref.com/en/players/35516eac/Wilson-Odobert"
2025,"Tottenham","Premier League","Pedro Porro","ESP","DF","25-256",1999,29,66,49,34,22,10,44,77,57.1,33,44,17,27,36,102,84,2,"https://fbref.com/en/players/27d0a506/Pedro-Porro"
2025,"Tottenham","Premier League","Sergio Reguilón","ESP","DF","28-162",1996,2.2,4,3,1,3,0,2,5,40,3,7,0,7,4,8,8,0,"https://fbref.com/en/players/3353737a/Sergio-Reguilon"
2025,"Tottenham","Premier League","Richarlison","BRA","FW","28-017",1997,5.6,5,3,0,4,1,0,3,0,3,1,1,0,0,5,8,0,"https://fbref.com/en/players/fa031b34/Richarlison"
2025,"Tottenham","Premier League","Cristian Romero","ARG","DF","27-030",1998,15.7,35,29,26,8,1,21,30,70,9,18,3,15,21,56,57,2,"https://fbref.com/en/players/a3d94a58/Cristian-Romero"
2025,"Tottenham","Premier League","Dane Scarlett","ENG","FW,MF","21-064",2004,0.4,1,0,0,1,0,0,0,NA,0,0,0,0,0,1,1,0,"https://fbref.com/en/players/21945a9e/Dane-Scarlett"
2025,"Tottenham","Premier League","Dominic Solanke","ENG","FW","27-255",1997,24.5,18,11,1,12,5,4,16,25,12,20,9,11,1,19,23,0,"https://fbref.com/en/players/e77dc3b2/Dominic-Solanke"
2025,"Tottenham","Premier League","Djed Spence","ENG","DF","24-291",2000,19.9,47,34,25,15,7,23,30,76.7,7,28,9,19,21,68,74,2,"https://fbref.com/en/players/9bc9a519/Djed-Spence"
2025,"Tottenham","Premier League","Mathys Tel","FRA","FW","20-030",2005,10.1,16,6,4,7,5,5,13,38.5,8,8,1,7,2,18,8,2,"https://fbref.com/en/players/829aa60c/Mathys-Tel"
2025,"Tottenham","Premier League","Destiny Udogie","ITA","DF","22-180",2002,21.4,75,47,42,26,7,33,48,68.8,15,40,6,34,22,97,36,1,"https://fbref.com/en/players/7cd520e8/Destiny-Udogie"
2025,"Tottenham","Premier League","Micky van de Ven","NED","DF","24-038",2001,11.3,10,6,5,4,1,8,14,57.1,6,12,8,4,10,20,39,1,"https://fbref.com/en/players/8fe2a392/Micky-van-de-Ven"
2025,"Tottenham","Premier League","Guglielmo Vicario","ITA","GK","28-232",1996,24,0,0,0,0,0,0,0,NA,0,0,0,0,1,1,14,6,"https://fbref.com/en/players/77d6fd4d/Guglielmo-Vicario"
2025,"Tottenham","Premier League","Timo Werner","GER","FW,MF","29-082",1996,5.7,6,4,3,3,0,3,13,23.1,10,10,1,9,1,7,7,0,"https://fbref.com/en/players/49fe9070/Timo-Werner"
2025,"Toulouse","Ligue 1","Zakaria Aboukhlal","MAR","MF,FW","25-098",2000,21.1,22,13,7,8,7,4,23,17.4,19,16,1,15,6,28,9,0,"https://fbref.com/en/players/c2a6033c/Zakaria-Aboukhlal"
2025,"Toulouse","Ligue 1","Ümit Akdag","ROU","DF","21-233",2003,5.6,8,4,3,4,1,5,12,41.7,7,10,8,2,11,19,19,0,"https://fbref.com/en/players/d746900e/Umit-Akdag"
2025,"Toulouse","Ligue 1","Shavy Babicka","GAB","MF,FW","24-360",2000,13.2,21,12,6,11,4,10,21,47.6,11,14,0,14,3,24,4,3,"https://fbref.com/en/players/c6f0d5d4/Shavy-Babicka"
2025,"Toulouse","Ligue 1","Jaydee Canvot","FRA","DF,MF","18-302",2006,12.3,23,11,16,5,2,12,18,66.7,6,10,2,8,11,34,54,1,"https://fbref.com/en/players/3684108d/Jaydee-Canvot"
2025,"Toulouse","Ligue 1","Cristian Cásseres Jr.","VEN","MF","25-127",2000,30,96,61,41,43,12,46,88,52.3,42,35,9,26,42,138,36,1,"https://fbref.com/en/players/f86fe8c1/Cristian-Casseres-Jr"
2025,"Toulouse","Ligue 1","Logan Costa","CPV","DF","24-056",2001,1,2,1,0,2,0,1,1,100,0,2,2,0,2,4,4,0,"https://fbref.com/en/players/bfb2056e/Logan-Costa"
2025,"Toulouse","Ligue 1","Charlie Cresswell","ENG","DF","22-283",2002,28.8,35,23,19,15,1,28,46,60.9,18,44,28,16,28,63,191,3,"https://fbref.com/en/players/4654e5f5/Charlie-Cresswell"
2025,"Toulouse","Ligue 1","Álex Domínguez","ESP","GK","26-301",1998,0.2,0,0,0,0,0,0,0,NA,0,0,0,0,0,0,0,0,"https://fbref.com/en/players/f240be08/Alex-Dominguez"
2025,"Toulouse","Ligue 1","Aron Dønnum","NOR","DF,MF","27-037",1998,29.9,56,35,25,24,7,31,55,56.4,24,29,4,25,28,84,37,1,"https://fbref.com/en/players/10cff752/Aron-Donnum"
2025,"Toulouse","Ligue 1","Noah Edjouma","FRA","MF,FW","19-235",2005,1.9,2,2,0,1,1,1,2,50,1,1,1,0,2,4,2,0,"https://fbref.com/en/players/92976f0d/Noah-Edjouma"
2025,"Toulouse","Ligue 1","Yann Gboho","FRA","MF,FW","24-133",2001,25.9,31,18,7,15,9,14,35,40,21,20,0,20,6,37,4,1,"https://fbref.com/en/players/6be41a31/Yann-Gboho"
2025,"Toulouse","Ligue 1","Denis Genreau","AUS","MF","26-006",1999,2.5,7,5,4,1,2,4,8,50,4,3,0,3,3,10,4,0,"https://fbref.com/en/players/badcdcae/Denis-Genreau"
2025,"Toulouse","Ligue 1","Kjetil Haug","NOR","GK","26-349",1998,5.5,0,0,0,0,0,0,0,NA,0,0,0,0,0,0,3,0,"https://fbref.com/en/players/d3ae48eb/Kjetil-Haug"
2025,"Toulouse","Ligue 1","Waren Kamanzi","NOR","DF,MF","24-197",2000,11.4,29,13,12,12,5,14,28,50,14,7,3,4,9,38,25,0,"https://fbref.com/en/players/a426a912/Waren-Kamanzi"
2025,"Toulouse","Ligue 1","Joshua King","NOR","FW,MF","33-132",1992,18.6,11,11,4,4,3,5,12,41.7,7,10,3,7,6,17,19,0,"https://fbref.com/en/players/43458538/Joshua-King"
2025,"Toulouse","Ligue 1","Frank Magri","CMR","FW,MF","25-265",1999,16.8,8,2,1,6,1,3,8,37.5,5,16,2,14,4,12,11,0,"https://fbref.com/en/players/42fdb11d/Frank-Magri"
2025,"Toulouse","Ligue 1","Mark McKenzie","USA","DF","26-091",1999,27.7,52,31,31,20,1,33,45,73.3,12,31,18,13,22,74,141,1,"https://fbref.com/en/players/a5f5d094/Mark-McKenzie"
2025,"Toulouse","Ligue 1","Rafik Messali","FRA","DF","22-029",2003,5.1,15,8,6,6,3,7,8,87.5,1,9,1,8,10,25,12,0,"https://fbref.com/en/players/bbc86fc4/Rafik-Messali"
2025,"Toulouse","Ligue 1","Rasmus Nicolaisen","DEN","DF","28-072",1997,6.9,6,3,4,2,0,3,5,60,2,10,5,5,10,16,25,0,"https://fbref.com/en/players/3f319bb9/Rasmus-Nicolaisen"
2025,"Toulouse","Ligue 1","Guillaume Restes","FRA","GK","20-077",2005,28.3,2,1,2,0,0,2,3,66.7,1,0,0,0,1,3,16,1,"https://fbref.com/en/players/6b91b999/Guillaume-Restes"
2025,"Toulouse","Ligue 1","Niklas Schmidt","GER","MF","27-087",1998,2.3,6,4,1,5,0,4,7,57.1,3,0,0,0,1,7,4,0,"https://fbref.com/en/players/b9ae8560/Niklas-Schmidt"
2025,"Toulouse","Ligue 1","Djibril Sidibé","FRA","DF","32-302",1992,23.3,65,36,34,22,9,31,50,62,19,11,3,8,20,85,64,1,"https://fbref.com/en/players/4c5b714f/Djibril-Sidibe"
2025,"Toulouse","Ligue 1","Vincent Sierro","SUI","MF","29-231",1995,26.7,44,27,15,23,6,27,56,48.2,29,34,9,25,16,60,44,1,"https://fbref.com/en/players/92ffb8f9/Vincent-Sierro"
2025,"Toulouse","Ligue 1","Naatan Skyttä","FIN","FW","23-020",2002,0.1,1,0,0,0,1,0,0,NA,0,0,0,0,0,1,0,0,"https://fbref.com/en/players/d7547531/Naatan-Skytta"
2025,"Toulouse","Ligue 1","Gabriel Suazo","CHI","DF","27-291",1997,24,59,39,25,22,12,30,72,41.7,42,27,3,24,36,95,40,1,"https://fbref.com/en/players/39b326ed/Gabriel-Suazo"
2025,"Toulouse","Ligue 1","Miha Zajc","SVN","MF","30-330",1994,2.9,4,4,1,2,1,3,5,60,2,2,1,1,3,7,7,0,"https://fbref.com/en/players/83e4643e/Miha-Zajc"
2025,"Toulouse","Ligue 1","Edhy Zuliani","ITA","DF","20-289",2004,0.1,0,0,0,0,0,0,0,NA,0,0,0,0,1,1,0,0,"https://fbref.com/en/players/2a74ef47/Edhy-Zuliani"
2025,"Udinese","Serie A","James Abankwah","IRL","DF,MF","21-131",2004,1,4,2,4,0,0,2,3,66.7,1,2,1,1,1,5,3,0,"https://fbref.com/en/players/4b7a9fcc/James-Abankwah"
2025,"Udinese","Serie A","Arthur Atta","FRA","MF,FW","22-133",2003,13.9,20,12,9,10,1,10,15,66.7,5,9,5,4,7,27,15,1,"https://fbref.com/en/players/d3ddf88b/Arthur-Atta"
2025,"Udinese","Serie A","Jaka Bijol","SVN","DF","26-111",1999,32.9,43,25,32,10,1,21,40,52.5,19,38,18,20,38,81,182,1,"https://fbref.com/en/players/6fdac234/Jaka-Bijol"
2025,"Udinese","Serie A","Iker Bravo","ESP","FW,MF","20-134",2005,7.6,10,6,3,5,2,5,9,55.6,4,4,1,3,1,11,4,0,"https://fbref.com/en/players/db8c8860/Iker-Bravo"
2025,"Udinese","Serie A","Brenner","BRA","MF,FW","25-131",2000,4.3,6,4,2,3,1,3,8,37.5,5,4,0,4,1,7,6,0,"https://fbref.com/en/players/279508bf/Brenner"
2025,"Udinese","Serie A","Keinan Davis","ENG","FW","27-103",1998,11.8,9,4,1,4,4,3,6,50,3,2,1,1,1,10,5,0,"https://fbref.com/en/players/9deaf2c8/Keinan-Davis"
2025,"Udinese","Serie A","Enzo Ebosse","CMR","DF","26-077",1999,1,0,0,0,0,0,0,2,0,2,3,3,0,1,1,1,0,"https://fbref.com/en/players/9ba7b4fa/Enzo-Ebosse"
2025,"Udinese","Serie A","Kingsley Ehizibue","NED","DF","30-002",1995,27.8,55,35,31,18,6,25,41,61,16,41,14,27,23,78,70,5,"https://fbref.com/en/players/76b2817e/Kingsley-Ehizibue"
2025,"Udinese","Serie A","Jurgen Ekkelenkamp","NED","MF","25-052",2000,21,36,25,10,22,4,18,35,51.4,17,26,4,22,12,48,26,0,"https://fbref.com/en/players/73d6a176/Jurgen-Ekkelenkamp"
2025,"Udinese","Serie A","Lautaro Gianetti","ARG","DF","31-195",1993,9.8,22,10,16,5,1,14,20,70,6,20,10,10,15,37,49,1,"https://fbref.com/en/players/e08ac719/Lautaro-Gianetti"
2025,"Udinese","Serie A","Christian Kabasele","BEL","DF","34-092",1991,12.9,17,9,10,7,0,11,14,78.6,3,14,8,6,14,31,75,1,"https://fbref.com/en/players/914ab9a1/Christian-Kabasele"
2025,"Udinese","Serie A","Hassane Kamara","CIV","DF","31-083",1994,22.2,35,25,20,11,4,16,28,57.1,12,23,5,18,26,61,49,1,"https://fbref.com/en/players/19a12bed/Hassane-Kamara"
2025,"Udinese","Serie A","Jesper Karlström","SWE","MF","29-340",1995,35.4,61,34,32,21,8,25,51,49,26,28,11,17,35,96,82,5,"https://fbref.com/en/players/e0a1f4eb/Jesper-Karlstrom"
2025,"Udinese","Serie A","Thomas Kristensen","DEN","DF","23-130",2002,19.5,31,21,16,11,4,20,32,62.5,12,18,13,5,21,52,80,2,"https://fbref.com/en/players/fadf9a05/Thomas-Kristensen"
2025,"Udinese","Serie A","Sandi Lovrić","SVN","MF","27-060",1998,25.6,46,29,25,17,4,22,44,50,22,33,5,28,22,68,27,1,"https://fbref.com/en/players/966eea58/Sandi-Lovric"
2025,"Udinese","Serie A","Lorenzo Lucca","ITA","FW","24-259",2000,26.1,10,6,3,2,5,5,11,45.5,6,18,1,17,7,17,27,0,"https://fbref.com/en/players/83c06f3a/Lorenzo-Lucca"
2025,"Udinese","Serie A","Rui Modesto","ANG","DF,MF","25-232",1999,6.8,16,12,4,9,3,7,9,77.8,2,10,0,10,8,24,13,0,"https://fbref.com/en/players/4f9c2d8c/Rui-Modesto"
2025,"Udinese","Serie A","Maduka Okoye","NGA","GK","25-272",1999,25,0,0,0,0,0,0,0,NA,0,0,0,0,0,0,12,1,"https://fbref.com/en/players/ab5c36dd/Maduka-Okoye"
2025,"Udinese","Serie A","Daniele Padelli","ITA","GK","39-214",1985,1,0,0,0,0,0,0,1,0,1,0,0,0,0,0,0,0,"https://fbref.com/en/players/cf1c23d8/Daniele-Padelli"
2025,"Udinese","Serie A","Simone Pafundi","ITA","MF,DF","19-102",2006,1.3,3,3,2,0,1,1,4,25,3,0,0,0,0,3,1,0,"https://fbref.com/en/players/8daee720/Simone-Pafundi"
2025,"Udinese","Serie A","Matteo Palma","GER","DF","17-075",2008,0.1,0,0,0,0,0,0,0,NA,0,1,1,0,0,0,1,0,"https://fbref.com/en/players/cb2e6751/Matteo-Palma"
2025,"Udinese","Serie A","Martín Payero","ARG","MF","26-258",1998,15.3,24,16,4,14,6,8,16,50,8,16,2,14,13,37,13,0,"https://fbref.com/en/players/bdbff2b5/Martin-Payero"
2025,"Udinese","Serie A","Nehuén Pérez","ARG","DF","24-337",2000,2,1,1,0,0,1,0,1,0,1,2,2,0,1,2,7,0,"https://fbref.com/en/players/f7c491f1/Nehuen-Perez"
2025,"Udinese","Serie A","Damián Pizarro","CHI","FW,MF","20-060",2005,0.2,0,0,0,0,0,0,0,NA,0,0,0,0,0,0,0,0,"https://fbref.com/en/players/464e03ef/Damian-Pizarro"
2025,"Udinese","Serie A","Alexis Sánchez","CHI","FW","36-159",1988,4.9,3,1,0,2,1,1,7,14.3,6,5,0,5,4,7,1,1,"https://fbref.com/en/players/2c0f8e9e/Alexis-Sanchez"
2025,"Udinese","Serie A","Razvan Sava","ROU","GK","22-340",2002,12,0,0,0,0,0,0,0,NA,0,0,0,0,0,0,6,2,"https://fbref.com/en/players/41efbd34/Razvan-Sava"
2025,"Udinese","Serie A","Oumar Solet","FRA","DF","25-109",2000,18.6,33,19,18,13,2,21,30,70,9,32,19,13,17,50,78,4,"https://fbref.com/en/players/0670ee51/Oumar-Solet"
2025,"Udinese","Serie A","Florian Thauvin","FRA","FW,MF","32-121",1993,21.7,20,14,9,8,3,10,25,40,15,6,0,6,7,27,10,0,"https://fbref.com/en/players/2b9fdeea/Florian-Thauvin"
2025,"Udinese","Serie A","Souleymane Touré","FRA","DF","22-060",2003,8.1,7,6,4,3,0,4,5,80,1,15,6,9,9,16,17,1,"https://fbref.com/en/players/01fd01e8/Souleymane-Toure"
2025,"Udinese","Serie A","Oier Zarraga","ESP","MF","26-143",1999,10,19,13,7,10,2,10,22,45.5,12,9,5,4,2,21,8,0,"https://fbref.com/en/players/968a1c2f/Oier-Zarraga"
2025,"Udinese","Serie A","Jordan Zemura","ZIM","DF","25-194",1999,15.7,31,14,14,12,5,17,29,58.6,12,17,4,13,16,47,41,0,"https://fbref.com/en/players/e8271ad9/Jordan-Zemura"
2025,"Union Berlin","Bundesliga","László Bénes","SVK","MF,FW","27-260",1997,6.5,2,2,1,1,0,1,3,33.3,2,5,1,4,3,5,9,0,"https://fbref.com/en/players/fe888e39/Laszlo-Benes"
2025,"Union Berlin","Bundesliga","Danilho Doekhi","NED","DF","26-331",1998,34,37,24,18,16,3,13,23,56.5,10,35,16,19,44,81,169,1,"https://fbref.com/en/players/f67c9d29/Danilho-Doekhi"
2025,"Union Berlin","Bundesliga","Robin Gosens","GER","DF","30-326",1994,1,0,0,0,0,0,0,3,0,3,1,0,1,1,1,2,0,"https://fbref.com/en/players/2d970560/Robin-Gosens"
2025,"Union Berlin","Bundesliga","Janik Haberer","GER","MF,DF","31-055",1994,18.8,39,29,16,21,2,26,44,59.1,18,16,0,16,17,56,37,0,"https://fbref.com/en/players/70dcf94d/Janik-Haberer"
2025,"Union Berlin","Bundesliga","Benedict Hollerbach","GER","FW,MF","24-010",2001,28.2,43,22,8,23,12,21,51,41.2,30,35,0,35,2,45,13,1,"https://fbref.com/en/players/2a158218/Benedict-Hollerbach"
2025,"Union Berlin","Bundesliga","Andrej Ilic","SRB","FW","25-054",2000,10.4,2,2,0,2,0,0,6,0,6,7,3,4,5,7,6,1,"https://fbref.com/en/players/cd2cb5bb/Andrej-Ilic"
2025,"Union Berlin","Bundesliga","Josip Juranović","CRO","DF,MF","29-284",1995,12.9,21,13,12,6,3,10,25,40,15,13,6,7,7,28,42,2,"https://fbref.com/en/players/0a084b35/Josip-Juranovic"
2025,"Union Berlin","Bundesliga","Aljoscha Kemlein","GER","MF","20-298",2004,10.2,10,4,4,5,1,5,14,35.7,9,14,3,11,6,16,15,0,"https://fbref.com/en/players/4658e309/Aljoscha-Kemlein"
2025,"Union Berlin","Bundesliga","Rani Khedira","GER","MF","31-120",1994,30.3,68,40,30,35,3,24,38,63.2,14,33,11,22,44,112,55,0,"https://fbref.com/en/players/59e4b92e/Rani-Khedira"
2025,"Union Berlin","Bundesliga","Diogo Leite","POR","DF","26-124",1999,28.3,64,32,43,17,4,33,50,66,17,61,25,36,57,121,162,1,"https://fbref.com/en/players/c4987edc/Diogo-Leite"
2025,"Union Berlin","Bundesliga","Marin Ljubicic","CRO","FW,MF","23-088",2002,3.1,2,1,0,2,0,1,3,33.3,2,2,0,2,0,2,7,0,"https://fbref.com/en/players/774b7f08/Marin-Ljubicic"
2025,"Union Berlin","Bundesliga","Jordan Pefok","USA","FW","29-031",1996,10.1,11,6,6,0,5,3,7,42.9,4,9,2,7,4,15,18,0,"https://fbref.com/en/players/b684a484/Jordan-Pefok"
2025,"Union Berlin","Bundesliga","David Preu","GER","MF,DF","20-213",2004,1.3,1,1,0,1,0,0,2,0,2,4,2,2,0,1,2,0,"https://fbref.com/en/players/6dcc8d89/David-Preu"
2025,"Union Berlin","Bundesliga","Ivan Prtajin","CRO","FW","29-013",1996,1.8,3,2,0,1,2,0,0,NA,0,2,0,2,0,3,3,0,"https://fbref.com/en/players/f297a3f1/Ivan-Prtajin"
2025,"Union Berlin","Bundesliga","Leopold Querfeld","AUT","DF","21-158",2003,19.4,25,12,21,4,0,13,18,72.2,5,25,10,15,19,44,144,2,"https://fbref.com/en/players/9fd158d6/Leopold-Querfeld"
2025,"Union Berlin","Bundesliga","Tom Rothe","GER","DF,MF","20-210",2004,18.6,45,28,27,15,3,29,51,56.9,22,41,5,36,18,63,57,1,"https://fbref.com/en/players/90c1f9a4/Tom-Rothe"
2025,"Union Berlin","Bundesliga","Jérôme Roussillon","FRA","DF,MF","32-141",1993,1.5,0,0,0,0,0,0,2,0,2,0,0,0,2,2,7,0,"https://fbref.com/en/players/13203c45/Jerome-Roussillon"
2025,"Union Berlin","Bundesliga","Frederik Rønnow","DEN","GK","32-296",1992,28,0,0,0,0,0,0,1,0,1,0,0,0,0,0,22,2,"https://fbref.com/en/players/a70b8345/Frederik-Ronnow"
2025,"Union Berlin","Bundesliga","András Schäfer","HUN","MF","26-044",1999,17,52,26,23,24,5,25,41,61,16,33,6,27,22,74,36,0,"https://fbref.com/en/players/049751d7/Andras-Schafer"
2025,"Union Berlin","Bundesliga","Alexander Schwolow","GER","GK","32-359",1992,6,0,0,0,0,0,0,0,NA,0,0,0,0,0,0,2,1,"https://fbref.com/en/players/0d55d942/Alexander-Schwolow"
2025,"Union Berlin","Bundesliga","Tim Skarke","GER","FW,MF","28-262",1996,12.9,14,11,5,8,1,10,19,52.6,9,7,0,7,5,19,17,0,"https://fbref.com/en/players/65857fdf/Tim-Skarke"
2025,"Union Berlin","Bundesliga","Robert Skov","DEN","DF,MF","29-007",1996,9.5,15,11,8,7,0,10,20,50,10,8,1,7,8,23,9,0,"https://fbref.com/en/players/ff98492b/Robert-Skov"
2025,"Union Berlin","Bundesliga","Lucas Tousart","FRA","MF","28-028",1997,6.2,17,9,6,9,2,5,12,41.7,7,11,4,7,7,24,27,0,"https://fbref.com/en/players/71ec39ef/Lucas-Tousart"
2025,"Union Berlin","Bundesliga","Christopher Trimmel","AUT","DF,MF","38-092",1987,19.3,38,25,23,14,1,28,42,66.7,14,14,6,8,18,56,92,0,"https://fbref.com/en/players/056d2d95/Christopher-Trimmel"
2025,"Union Berlin","Bundesliga","Yorbe Vertessen","BEL","MF,FW","24-139",2001,8,6,3,3,2,1,2,8,25,6,6,0,6,3,9,6,0,"https://fbref.com/en/players/e8ef59da/Yorbe-Vertessen"
2025,"Union Berlin","Bundesliga","Kevin Vogt","GER","DF","33-246",1991,15.2,12,8,7,5,0,8,13,61.5,5,16,8,8,9,21,75,1,"https://fbref.com/en/players/1d8e9add/Kevin-Vogt"
2025,"Union Berlin","Bundesliga","Kevin Volland","GER","FW,MF","32-301",1992,0.7,0,0,0,0,0,0,0,NA,0,1,0,1,0,0,1,0,"https://fbref.com/en/players/64f69877/Kevin-Volland"
2025,"Union Berlin","Bundesliga","Jeong Woo-yeong","KOR","MF,FW","25-249",1999,14,10,7,5,5,0,3,11,27.3,8,10,1,9,11,21,11,0,"https://fbref.com/en/players/6190474d/Jeong-Woo-yeong"
2025,"Valencia","La Liga","Max Aarons","ENG","DF,MF","25-143",2000,1.3,4,4,2,2,0,4,5,80,1,1,0,1,0,4,3,0,"https://fbref.com/en/players/774cf58b/Max-Aarons"
2025,"Valencia","La Liga","Rodrigo Abajas","ESP","DF","22-015",2003,0.7,3,2,2,1,0,3,3,100,0,1,0,1,1,4,0,0,"https://fbref.com/en/players/69c99fce/Rodrigo-Abajas"
2025,"Valencia","La Liga","Domingos André Ribeiro Almeida","POR","MF,FW","24-362",2000,22,48,32,18,21,9,14,39,35.9,25,21,3,18,8,56,14,1,"https://fbref.com/en/players/e6697917/Domingos-Andre-Ribeiro-Almeida"
2025,"Valencia","La Liga","Enzo Barrenechea","ARG","MF","24-005",2001,24.3,57,30,22,29,6,32,46,69.6,14,30,8,22,28,85,48,1,"https://fbref.com/en/players/6caffe81/Enzo-Barrenechea"
2025,"Valencia","La Liga","Sergi Canós","ESP","MF,FW","28-114",1997,4.1,11,7,3,4,4,4,10,40,6,6,1,5,5,16,5,0,"https://fbref.com/en/players/1137759d/Sergi-Canos"
2025,"Valencia","La Liga","Maximiliano Caufriez","BEL","DF","28-100",1997,1,1,1,1,0,0,1,1,100,0,2,1,1,1,2,4,0,"https://fbref.com/en/players/c92c24f0/Maximiliano-Caufriez"
2025,"Valencia","La Liga","Iker Córdoba","ESP","DF","19-197",2005,0.2,0,0,0,0,0,0,0,NA,0,0,0,0,0,0,1,0,"https://fbref.com/en/players/f35d5b6a/Iker-Cordoba"
2025,"Valencia","La Liga","Thierry Correia","POR","DF","26-079",1999,8.5,27,18,19,5,3,13,23,56.5,10,10,1,9,4,31,18,0,"https://fbref.com/en/players/c78b352d/Thierry-Correia"
2025,"Valencia","La Liga","Mouctar Diakhaby","GUI","DF","28-159",1996,7.3,8,3,8,0,0,4,6,66.7,2,8,6,2,11,19,56,0,"https://fbref.com/en/players/d2110326/Mouctar-Diakhaby"
2025,"Valencia","La Liga","Stole Dimitrievski","MKD","GK","31-153",1993,4,0,0,0,0,0,0,0,NA,0,0,0,0,0,0,3,1,"https://fbref.com/en/players/fc70e345/Stole-Dimitrievski"
2025,"Valencia","La Liga","Hugo Duro","ESP","FW","25-198",1999,24.1,13,8,4,7,2,5,13,38.5,8,11,2,9,10,23,11,0,"https://fbref.com/en/players/37e103f8/Hugo-Duro"
2025,"Valencia","La Liga","Dimitri Foulquier","FRA","DF","32-065",1993,25.5,48,31,29,13,6,24,36,66.7,12,21,5,16,16,64,86,1,"https://fbref.com/en/players/45e17712/Dimitri-Foulquier"
2025,"Valencia","La Liga","Yarek Gasiorowski","ESP","DF","20-135",2005,10.5,19,16,16,3,0,9,13,69.2,4,17,6,11,26,45,60,0,"https://fbref.com/en/players/20a65cdf/Yarek-Gasiorowski"
2025,"Valencia","La Liga","Dani Gómez","ESP","FW","26-301",1998,5.9,3,2,0,0,3,0,0,NA,0,1,0,1,2,5,4,0,"https://fbref.com/en/players/0e5ddc7c/Dani-Gomez"
2025,"Valencia","La Liga","Javier Guerra","ESP","MF","22-146",2003,28.7,50,27,18,21,11,26,56,46.4,30,15,3,12,20,70,49,3,"https://fbref.com/en/players/3828f130/Javier-Guerra"
2025,"Valencia","La Liga","Hugo Guillamón","ESP","MF","25-116",2000,4,11,8,1,9,1,9,10,90,1,4,1,3,5,16,9,1,"https://fbref.com/en/players/f7c12fbf/Hugo-Guillamon"
2025,"Valencia","La Liga","Ivan Jaime Pajuelo","ESP","MF","24-243",2000,3.3,8,5,2,3,3,4,5,80,1,2,0,2,2,10,0,0,"https://fbref.com/en/players/90ba7fa6/Ivan-Jaime-Pajuelo"
2025,"Valencia","La Liga","Diego López","ESP","MF,FW","23-014",2002,30.4,31,18,11,16,4,16,47,34,31,30,0,30,16,47,15,0,"https://fbref.com/en/players/c487901c/Diego-Lopez"
2025,"Valencia","La Liga","José Luis Gayà","ESP","DF","30-002",1995,20,57,40,39,15,3,40,58,69,18,16,2,14,25,82,61,0,"https://fbref.com/en/players/b05e2dbd/Jose-Luis-Gaya"
2025,"Valencia","La Liga","Giorgi Mamardashvili","GEO","GK","24-240",2000,34,2,2,2,0,0,2,3,66.7,1,0,0,0,1,3,16,3,"https://fbref.com/en/players/d4b73232/Giorgi-Mamardashvili"
2025,"Valencia","La Liga","Alberto Marí","ESP","FW","23-320",2001,0.1,0,0,0,0,0,0,0,NA,0,0,0,0,0,0,0,0,"https://fbref.com/en/players/44330c36/Alberto-Mari"
2025,"Valencia","La Liga","Rafa Mir","ESP","FW,MF","27-343",1997,8.4,12,6,8,4,0,3,9,33.3,6,5,0,5,5,17,9,0,"https://fbref.com/en/players/bbf5c11b/Rafa-Mir"
2025,"Valencia","La Liga","Cristhian Mosquera","ESP","DF","20-334",2004,36.9,56,36,41,13,2,31,40,77.5,9,37,24,13,35,91,128,4,"https://fbref.com/en/players/dc1ce4f5/Cristhian-Mosquera"
2025,"Valencia","La Liga","David Otorbi","ESP","MF","17-223",2007,0.2,0,0,0,0,0,0,0,NA,0,1,0,1,0,0,0,0,"https://fbref.com/en/players/c83e3553/David-Otorbi"
2025,"Valencia","La Liga","Francisco Perez","ESP","FW,MF","22-260",2002,6.3,17,12,7,8,2,10,16,62.5,6,8,1,7,3,20,6,0,"https://fbref.com/en/players/3d79a68c/Francisco-Perez"
2025,"Valencia","La Liga","Luis Rioja","ESP","MF,FW","31-223",1993,31.5,33,21,14,12,7,14,42,33.3,28,30,1,29,22,55,44,1,"https://fbref.com/en/players/eb3dd471/Luis-Rioja"
2025,"Valencia","La Liga","Umar Sadiq","NGA","FW","28-114",1997,9.2,10,5,3,5,2,4,6,66.7,2,7,0,7,1,11,7,0,"https://fbref.com/en/players/686cbe7d/Umar-Sadiq"
2025,"Valencia","La Liga","César Tárrega","ESP","DF","23-090",2002,33.6,49,37,33,13,3,19,31,61.3,12,41,20,21,22,71,222,2,"https://fbref.com/en/players/59c29820/Cesar-Tarrega"
2025,"Valencia","La Liga","Martín Tejón","ESP","MF,DF","21-045",2004,0.5,2,0,0,2,0,1,2,50,1,0,0,0,0,2,0,0,"https://fbref.com/en/players/f99cc198/Martin-Tejon"
2025,"Valencia","La Liga","Germán Valera","ESP","MF","23-072",2002,1.6,1,1,1,0,0,0,1,0,1,2,0,2,4,5,2,1,"https://fbref.com/en/players/84f55b4a/German-Valera"
2025,"Valencia","La Liga","José Luis García Vayá","ESP","MF","26-289",1998,19.4,43,25,24,13,6,19,33,57.6,14,23,6,17,19,62,42,0,"https://fbref.com/en/players/27dc1378/Jose-Luis-Garcia-Vaya"
2025,"Valencia","La Liga","Jesus Vazquez","ESP","DF","22-145",2003,10.2,23,18,12,9,2,10,19,52.6,9,16,5,11,10,33,30,0,"https://fbref.com/en/players/106c142c/Jesus-Vazquez"
2025,"Valladolid","La Liga","Joseph Aidoo","GHA","DF","29-240",1995,6.5,5,5,3,2,0,2,3,66.7,1,8,4,4,5,10,26,1,"https://fbref.com/en/players/18abe173/Joseph-Aidoo"
2025,"Valladolid","La Liga","Ibrahim Alani","NGA","MF","18-302",2006,1.8,12,7,8,4,0,4,6,66.7,2,3,1,2,1,13,1,0,"https://fbref.com/en/players/36fd9c52/Ibrahim-Alani"
2025,"Valladolid","La Liga","Selim Amallah","MAR","MF","28-193",1996,15.3,30,18,10,18,2,10,18,55.6,8,24,2,22,14,44,5,1,"https://fbref.com/en/players/00eba9c9/Selim-Amallah"
2025,"Valladolid","La Liga","Amath","SEN","FW,DF","28-315",1996,4.2,2,0,2,0,0,1,8,12.5,7,7,1,6,2,4,6,0,"https://fbref.com/en/players/f3b1d9a2/Amath"
2025,"Valladolid","La Liga","Marcos André","BRA","FW","28-219",1996,13.2,10,6,3,5,2,5,13,38.5,8,18,2,16,3,13,10,0,"https://fbref.com/en/players/ae86d473/Marcos-Andre"
2025,"Valladolid","La Liga","Anuar","MAR","MF,FW","30-132",1995,19.1,38,27,21,12,5,15,28,53.6,13,24,8,16,18,56,26,1,"https://fbref.com/en/players/c93231dc/Anuar"
2025,"Valladolid","La Liga","Adam Aznou","MAR","DF","18-359",2006,9.7,28,21,20,8,0,21,43,48.8,22,24,8,16,10,38,30,0,"https://fbref.com/en/players/e678d983/Adam-Aznou"
2025,"Valladolid","La Liga","Juma Bah","SLE","DF","19-046",2006,9.6,10,7,7,3,0,3,5,60,2,15,8,7,12,22,60,0,"https://fbref.com/en/players/7b505397/Juma-Bah"
2025,"Valladolid","La Liga","Adrian Baquerin","ESP","FW","18-084",2007,0.5,1,1,0,1,0,0,0,NA,0,0,0,0,0,1,1,0,"https://fbref.com/en/players/218bc8d2/Adrian-Baquerin"
2025,"Valladolid","La Liga","Enzo Boyomo","CMR","DF","23-232",2001,3,6,2,4,2,0,3,3,100,0,4,3,1,1,7,7,0,"https://fbref.com/en/players/3a99bc13/Enzo-Boyomo"
2025,"Valladolid","La Liga","Antonio Candela","ITA","DF","25-030",2000,10.1,9,6,6,2,1,4,11,36.4,7,11,6,5,6,15,33,0,"https://fbref.com/en/players/d4307c52/Antonio-Candela"
2025,"Valladolid","La Liga","Raúl Chasco","ESP","DF","21-256",2003,1.4,4,1,3,1,0,2,4,50,2,1,0,1,2,6,2,0,"https://fbref.com/en/players/61d964b8/Raul-Chasco"
2025,"Valladolid","La Liga","Eray Cömert","SUI","DF,MF","27-112",1998,19.8,24,14,15,9,0,12,21,57.1,9,28,15,13,24,48,75,2,"https://fbref.com/en/players/15937e17/Eray-Comert"
2025,"Valladolid","La Liga","André Ferreira","POR","GK","28-363",1996,6,0,0,0,0,0,0,0,NA,0,0,0,0,0,0,4,2,"https://fbref.com/en/players/12c6cbef/Andre-Ferreira"
2025,"Valladolid","La Liga","Florian Grillitsch","AUT","MF","29-293",1995,6.9,11,7,7,3,1,7,15,46.7,8,12,2,10,4,15,5,1,"https://fbref.com/en/players/ffbbc83b/Florian-Grillitsch"
2025,"Valladolid","La Liga","Henrique","BRA","DF","31-032",1994,3.9,6,2,3,2,1,1,4,25,3,5,0,5,3,9,12,0,"https://fbref.com/en/players/f28474a4/Henrique"
2025,"Valladolid","La Liga","Karl Jakob Hein","EST","GK","23-044",2002,31,0,0,0,0,0,0,2,0,2,0,0,0,0,0,19,2,"https://fbref.com/en/players/aa81d8f8/Karl-Jakob-Hein"
2025,"Valladolid","La Liga","Stanko Jurić","CRO","MF","28-284",1996,19.2,48,24,26,19,3,19,48,39.6,29,35,11,24,24,72,52,0,"https://fbref.com/en/players/21a87181/Stanko-Juric"
2025,"Valladolid","La Liga","Kenedy","BRA","MF,FW","29-108",1996,0.1,0,0,0,0,0,0,0,NA,0,1,0,1,0,0,0,0,"https://fbref.com/en/players/5eebbfdf/Kenedy"
2025,"Valladolid","La Liga","Juanmi Latasa","ESP","FW","24-065",2001,15.5,4,2,1,1,2,2,6,33.3,4,4,1,3,0,4,11,1,"https://fbref.com/en/players/2bea832e/Juanmi-Latasa"
2025,"Valladolid","La Liga","Darwin Machís","VEN","MF,FW","32-109",1993,7.1,5,4,3,2,0,3,9,33.3,6,3,0,3,5,10,13,0,"https://fbref.com/en/players/ed6ea4d9/Darwin-Machis"
2025,"Valladolid","La Liga","Mario Maroto","ESP","MF","21-180",2003,0.7,0,0,0,0,0,0,2,0,2,0,0,0,2,2,2,0,"https://fbref.com/en/players/b518c5ab/Mario-Maroto"
2025,"Valladolid","La Liga","Mario Martín","ESP","MF","21-083",2004,19.4,62,32,31,27,4,21,49,42.9,28,32,7,25,21,83,46,7,"https://fbref.com/en/players/a9aff11a/Mario-Martin"
2025,"Valladolid","La Liga","Víctor Meseguer","ESP","MF","25-352",1999,4.6,10,6,4,4,2,2,10,20,8,3,0,3,2,12,4,1,"https://fbref.com/en/players/428a06a7/Victor-Meseguer"
2025,"Valladolid","La Liga","Xavier Moreno","ESP","FW","20-203",2004,0.5,0,0,0,0,0,0,0,NA,0,0,0,0,0,0,1,0,"https://fbref.com/en/players/b7584ab8/Xavier-Moreno"
2025,"Valladolid","La Liga","Raúl Moro","ESP","MF,FW","22-173",2002,26,22,13,15,4,3,13,32,40.6,19,8,0,8,10,32,20,1,"https://fbref.com/en/players/919dd4b1/Raul-Moro"
2025,"Valladolid","La Liga","Tamás Nikitscher","HUN","MF,DF","25-205",1999,9.5,17,8,8,9,0,8,13,61.5,5,17,4,13,11,28,16,1,"https://fbref.com/en/players/a1c7fe4e/Tamas-Nikitscher"
2025,"Valladolid","La Liga","Lucas Oliveira Rosa","BRA","DF","25-054",2000,21,53,33,40,11,2,35,51,68.6,16,24,9,15,28,81,69,2,"https://fbref.com/en/players/5132b92c/Lucas-Oliveira-Rosa"
2025,"Valladolid","La Liga","Cenk Özkacar","TUR","DF","24-233",2000,8.4,9,5,7,2,0,4,14,28.6,10,9,6,3,18,27,69,1,"https://fbref.com/en/players/9a93efc9/Cenk-Ozkacar"
2025,"Valladolid","La Liga","Iago Parente","ESP","DF","19-091",2006,0.8,0,0,0,0,0,0,0,NA,0,0,0,0,0,0,2,0,"https://fbref.com/en/players/c9bdd4b2/Iago-Parente"
2025,"Valladolid","La Liga","Kike Pérez","ESP","MF","28-102",1997,13.2,37,26,15,19,3,15,26,57.7,11,16,4,12,7,44,18,0,"https://fbref.com/en/players/237a3851/Kike-Perez"
2025,"Valladolid","La Liga","Luis Pérez","ESP","DF","30-112",1995,28.4,41,30,25,11,5,24,40,60,16,26,9,17,29,70,86,0,"https://fbref.com/en/players/b7c04927/Luis-Perez"
2025,"Valladolid","La Liga","Arnau Rafús","ESP","GK","22-030",2003,1,0,0,0,0,0,0,0,NA,0,0,0,0,0,0,0,1,"https://fbref.com/en/players/05d950c4/Arnau-Rafus"
2025,"Valladolid","La Liga","Chuky san jose","ESP","MF","21-028",2004,8.1,8,2,3,3,2,2,9,22.2,7,4,1,3,0,8,4,0,"https://fbref.com/en/players/0525a80f/Chuky-san-jose"
2025,"Valladolid","La Liga","Iván Sánchez","ESP","MF,FW","32-246",1992,15.6,37,20,18,10,9,12,27,44.4,15,18,3,15,14,51,10,0,"https://fbref.com/en/players/70107d4d/Ivan-Sanchez"
2025,"Valladolid","La Liga","Javi Sánchez","ESP","DF","28-074",1997,22.5,26,16,19,6,1,17,26,65.4,9,39,28,11,22,48,111,3,"https://fbref.com/en/players/60359288/Javi-Sanchez"
2025,"Valladolid","La Liga","Mamadou Sylla","SEN","FW,MF","31-068",1994,17.6,8,4,3,3,2,2,9,22.2,7,8,0,8,3,11,14,1,"https://fbref.com/en/players/e5ec95f8/Mamadou-Sylla"
2025,"Valladolid","La Liga","David Torres","ESP","DF","22-083",2003,15.4,13,8,12,1,0,7,11,63.6,4,19,17,2,10,23,74,0,"https://fbref.com/en/players/381dbcfc/David-Torres"
2025,"Venezia","Serie A","Giorgio Altare","ITA","DF","26-291",1998,8.4,13,12,8,3,2,8,15,53.3,7,21,11,10,17,30,49,0,"https://fbref.com/en/players/aa5322d5/Giorgio-Altare"
2025,"Venezia","Serie A","Bjarki Bjarkason","ISL","DF,MF","25-016",2000,1.8,3,2,2,1,0,1,2,50,1,1,0,1,2,5,4,0,"https://fbref.com/en/players/f1d25de7/Bjarki-Bjarkason"
2025,"Venezia","Serie A","Gianluca Busio","USA","MF","22-364",2002,28,46,31,24,12,10,20,47,42.6,27,36,8,28,19,65,52,0,"https://fbref.com/en/players/4a0b7f07/Gianluca-Busio"
2025,"Venezia","Serie A","Fali Candé","GNB","DF","27-123",1998,17,25,19,14,10,1,16,23,69.6,7,21,15,6,15,40,90,2,"https://fbref.com/en/players/3cc4bb19/Fali-Cande"
2025,"Venezia","Serie A","Antonio Candela","ITA","DF","25-030",2000,11.2,31,21,13,11,7,18,26,69.2,8,7,5,2,8,39,22,2,"https://fbref.com/en/players/d4307c52/Antonio-Candela"
2025,"Venezia","Serie A","Franco Carboni","ITA","DF","22-053",2003,2.5,5,3,5,0,0,5,8,62.5,3,1,1,0,0,5,11,0,"https://fbref.com/en/players/b033f803/Franco-Carboni"
2025,"Venezia","Serie A","Domen Črnigoj","SVN","MF","29-190",1995,1.5,4,2,0,1,3,1,2,50,1,5,2,3,4,8,4,0,"https://fbref.com/en/players/22cd43d2/Domen-Crnigoj"
2025,"Venezia","Serie A","Issa Doumbia","CIV","MF","21-223",2003,10.4,14,8,6,7,1,7,17,41.2,10,17,5,12,9,23,14,1,"https://fbref.com/en/players/b74fc282/Issa-Doumbia"
2025,"Venezia","Serie A","Alfred Duncan","GHA","MF","32-078",1993,10.6,17,8,4,11,2,5,14,35.7,9,7,2,5,8,25,8,0,"https://fbref.com/en/players/528492ea/Alfred-Duncan"
2025,"Venezia","Serie A","Mikael Ellertsson","ISL","DF,MF","23-077",2002,27.4,58,26,37,14,7,33,61,54.1,28,42,5,37,17,75,79,0,"https://fbref.com/en/players/c55967eb/Mikael-Ellertsson"
2025,"Venezia","Serie A","Daniel Fila","CZE","FW","22-279",2002,5.5,2,0,0,1,1,0,2,0,2,6,0,6,0,2,5,0,"https://fbref.com/en/players/383a628e/Daniel-Fila"
2025,"Venezia","Serie A","Christian Gytkjær","DEN","FW","35-021",1990,8.4,6,4,2,2,2,1,2,50,1,3,1,2,0,6,8,0,"https://fbref.com/en/players/9250bcff/Christian-Gytkjaer"
2025,"Venezia","Serie A","Saad El Haddad","MAR","MF","19-307",2005,0.3,0,0,0,0,0,0,0,NA,0,0,0,0,0,0,0,0,"https://fbref.com/en/players/7b12dccc/Saad-El-Haddad"
2025,"Venezia","Serie A","Ridgeciano Haps","SUR","DF","31-349",1993,15.2,30,16,19,8,3,14,22,63.6,8,18,3,15,7,37,48,0,"https://fbref.com/en/players/c8d7131c/Ridgeciano-Haps"
2025,"Venezia","Serie A","Jay Idzes","IDN","DF","24-359",2000,34.7,45,29,24,17,4,17,33,51.5,16,52,32,20,32,77,156,0,"https://fbref.com/en/players/a54ef587/Jay-Idzes"
2025,"Venezia","Serie A","Jesse Joronen","FIN","GK","32-067",1993,7.8,0,0,0,0,0,0,0,NA,0,0,0,0,0,0,4,1,"https://fbref.com/en/players/7f66ea09/Jesse-Joronen"
2025,"Venezia","Serie A","Magnus Kofod Andersen","DEN","MF","26-017",1999,7.7,13,4,3,9,1,4,10,40,6,7,2,5,6,19,12,0,"https://fbref.com/en/players/a4731ebc/Magnus-Kofod-Andersen"
2025,"Venezia","Serie A","Nunzio Lella","ITA","MF","24-303",2000,0.1,0,0,0,0,0,0,0,NA,0,0,0,0,0,0,0,0,"https://fbref.com/en/players/c149e8a6/Nunzio-Lella"
2025,"Venezia","Serie A","Alessandro Marcandalli","ITA","DF","22-244",2002,3.9,8,6,6,2,0,3,6,50,3,6,3,3,2,10,26,0,"https://fbref.com/en/players/d3225ad1/Alessandro-Marcandalli"
2025,"Venezia","Serie A","Mirko Marić","CRO","FW","30-011",1995,4,6,3,5,1,0,2,5,40,3,3,1,2,1,7,10,0,"https://fbref.com/en/players/78338347/Mirko-Maric"
2025,"Venezia","Serie A","Hans Nicolussi Caviglia","ITA","MF","24-343",2000,31.8,47,28,17,22,8,29,64,45.3,35,39,12,27,28,75,55,2,"https://fbref.com/en/players/b136c945/Hans-Nicolussi-Caviglia"
2025,"Venezia","Serie A","Gaetano Oristanio","ITA","FW,MF","22-241",2002,25.7,17,13,5,8,4,7,15,46.7,8,16,0,16,6,23,6,1,"https://fbref.com/en/players/5cfc74fc/Gaetano-Oristanio"
2025,"Venezia","Serie A","Cheick Oumar Conde","GUI","MF","24-305",2000,1.7,6,5,3,2,1,2,5,40,3,7,2,5,4,10,3,0,"https://fbref.com/en/players/2f88752d/Cheick-Oumar-Conde"
2025,"Venezia","Serie A","Kike Pérez","ESP","MF","28-102",1997,12.4,41,25,18,12,11,18,44,40.9,26,14,2,12,10,51,15,0,"https://fbref.com/en/players/237a3851/Kike-Perez"
2025,"Venezia","Serie A","Nicholas Pierini","ITA","MF","26-294",1998,0.9,0,0,0,0,0,0,1,0,1,2,0,2,0,0,0,0,"https://fbref.com/en/players/7cc89a5f/Nicholas-Pierini"
2025,"Venezia","Serie A","Joel Pohjanpalo","FIN","FW","30-256",1994,17.8,3,3,1,2,0,0,4,0,4,7,4,3,4,7,24,0,"https://fbref.com/en/players/ea003d07/Joel-Pohjanpalo"
2025,"Venezia","Serie A","Ionuț Radu","ROU","GK","27-364",1997,15,0,0,0,0,0,0,0,NA,0,0,0,0,0,0,9,0,"https://fbref.com/en/players/67f649be/Ionut-Radu"
2025,"Venezia","Serie A","Antonio Raimondo","ITA","FW,DF","21-070",2004,1,2,1,1,1,0,0,0,NA,0,0,0,0,0,2,0,1,"https://fbref.com/en/players/ce1a6c7e/Antonio-Raimondo"
2025,"Venezia","Serie A","Richie Sagrado","BEL","DF","21-117",2004,1.6,2,2,1,1,0,1,1,100,0,1,0,1,3,5,4,0,"https://fbref.com/en/players/3e3190f1/Richie-Sagrado"
2025,"Venezia","Serie A","Joël Schingtienne","BEL","DF","22-288",2002,12.5,27,16,18,7,2,12,19,63.2,7,18,9,9,14,41,25,5,"https://fbref.com/en/players/35a4790e/Joel-Schingtienne"
2025,"Venezia","Serie A","Filip Stankovic","SRB","GK","23-091",2002,15.2,0,0,0,0,0,0,0,NA,0,0,0,0,0,0,11,2,"https://fbref.com/en/players/d34d8ed2/Filip-Stankovic"
2025,"Venezia","Serie A","Marin Šverko","CRO","DF","27-112",1998,12.4,20,9,14,6,0,10,12,83.3,2,10,5,5,16,36,45,3,"https://fbref.com/en/players/06dba850/Marin-Sverko"
2025,"Venezia","Serie A","Michael Svoboda","AUT","DF","26-224",1998,14.6,26,14,19,6,1,8,19,42.1,11,19,11,8,22,48,66,2,"https://fbref.com/en/players/8abd174d/Michael-Svoboda"
2025,"Venezia","Serie A","John Yeboah","ECU","FW,MF","24-338",2000,13.6,6,3,1,3,2,1,10,10,9,4,0,4,4,10,2,0,"https://fbref.com/en/players/8dfdc6c3/John-Yeboah"
2025,"Venezia","Serie A","Francesco Zampano","ITA","DF","31-239",1993,18.2,31,20,19,10,2,14,31,45.2,17,21,1,20,6,37,29,2,"https://fbref.com/en/players/8e45910b/Francesco-Zampano"
2025,"Venezia","Serie A","Alessio Zerbin","ITA","DF","26-085",1999,16.9,51,28,30,12,9,29,52,55.8,23,28,3,25,15,66,25,1,"https://fbref.com/en/players/d19ef4ef/Alessio-Zerbin"
2025,"Villarreal","La Liga","Ilias Akhomach","MAR","MF,FW","21-041",2004,6.5,12,7,4,4,4,6,12,50,6,8,0,8,3,15,13,0,"https://fbref.com/en/players/b8bd60fe/Ilias-Akhomach"
2025,"Villarreal","La Liga","Raúl Albiol","ESP","DF","39-265",1985,13.2,10,9,9,1,0,6,10,60,4,10,9,1,6,16,69,1,"https://fbref.com/en/players/4bd414c1/Raul-Albiol"
2025,"Villarreal","La Liga","Alex Baena","ESP","MF,FW","23-311",2001,28.8,28,15,6,14,8,10,39,25.6,29,29,2,27,22,50,22,2,"https://fbref.com/en/players/518f2234/Alex-Baena"
2025,"Villarreal","La Liga","Eric Bailly","CIV","DF","31-045",1994,6.9,12,4,6,6,0,3,4,75,1,12,6,6,6,18,29,0,"https://fbref.com/en/players/a1232f4e/Eric-Bailly"
2025,"Villarreal","La Liga","Thierno Barry","FRA","FW","22-218",2002,25.8,11,8,2,5,4,4,10,40,6,15,2,13,0,11,19,0,"https://fbref.com/en/players/52c3244b/Thierno-Barry"
2025,"Villarreal","La Liga","Juan Bernat","ESP","DF,MF","32-087",1993,2.4,9,7,7,1,1,4,5,80,1,3,1,2,1,10,4,0,"https://fbref.com/en/players/433dc9a2/Juan-Bernat"
2025,"Villarreal","La Liga","Tajon Buchanan","CAN","MF","26-108",1999,4.6,10,5,6,4,0,6,9,66.7,3,6,0,6,1,11,1,0,"https://fbref.com/en/players/3aca6420/Tajon-Buchanan"
2025,"Villarreal","La Liga","Pau Cabanes","ESP","MF,FW","20-099",2005,1.8,4,4,0,3,1,3,4,75,1,5,0,5,3,7,2,1,"https://fbref.com/en/players/53440b64/Pau-Cabanes"
2025,"Villarreal","La Liga","Sergi Cardona","ESP","DF","25-323",1999,32.7,71,48,44,20,7,49,79,62,30,52,7,45,40,111,122,1,"https://fbref.com/en/players/74e90475/Sergi-Cardona"
2025,"Villarreal","La Liga","Santi Comesaña","ESP","MF","28-234",1996,28.4,85,49,44,32,9,42,76,55.3,34,56,22,34,19,104,56,1,"https://fbref.com/en/players/5ae499d0/Santi-Comesana"
2025,"Villarreal","La Liga","Diego Conde","ESP","GK","26-211",1998,21.8,2,2,2,0,0,2,4,50,2,0,0,0,1,3,9,2,"https://fbref.com/en/players/4eae5bc4/Diego-Conde"
2025,"Villarreal","La Liga","Logan Costa","CPV","DF","24-056",2001,28.7,38,21,25,12,1,24,29,82.8,5,25,14,11,21,59,115,2,"https://fbref.com/en/players/bfb2056e/Logan-Costa"
2025,"Villarreal","La Liga","Arnaut Danjuma","NED","FW","28-116",1997,2.2,2,1,0,1,1,0,1,0,1,1,0,1,0,2,0,0,"https://fbref.com/en/players/f08490a6/Arnaut-Danjuma"
2025,"Villarreal","La Liga","Karl Etta","CMR","MF,FW","21-225",2003,0.4,0,0,0,0,0,0,1,0,1,1,0,1,0,0,0,0,"https://fbref.com/en/players/f0f499ea/Karl-Etta"
2025,"Villarreal","La Liga","Kiko Femenía","ESP","DF","34-114",1991,24.7,50,34,34,14,2,33,57,57.9,24,21,10,11,40,90,62,3,"https://fbref.com/en/players/e5d01ecf/Kiko-Femenia"
2025,"Villarreal","La Liga","Juan Foyth","ARG","DF","27-135",1998,16.9,25,15,15,6,4,11,16,68.8,5,26,17,9,19,44,119,3,"https://fbref.com/en/players/6c7762c3/Juan-Foyth"
2025,"Villarreal","La Liga","Pape Gueye","SEN","MF","26-123",1999,24.7,54,26,23,23,8,20,29,69,9,31,13,18,27,81,53,2,"https://fbref.com/en/players/7155e3e1/Pape-Gueye"
2025,"Villarreal","La Liga","Luiz Lúcio Reis Júnior","BRA","GK","24-133",2001,16.2,0,0,0,0,0,0,0,NA,0,0,0,0,0,0,14,1,"https://fbref.com/en/players/d0530e29/Luiz-Lucio-Reis-Junior"
2025,"Villarreal","La Liga","Willy Kambwala","FRA","DF","20-275",2004,12.4,17,12,14,2,1,10,12,83.3,2,10,7,3,10,27,56,1,"https://fbref.com/en/players/6a7353d7/Willy-Kambwala"
2025,"Villarreal","La Liga","Gerard Moreno","ESP","FW","33-050",1992,8,7,4,3,2,2,3,12,25,9,0,0,0,2,9,8,0,"https://fbref.com/en/players/81f0781e/Gerard-Moreno"
2025,"Villarreal","La Liga","Pau Navarro","ESP","DF","20-032",2005,10.2,23,17,15,6,2,19,39,48.7,20,13,6,7,4,27,41,0,"https://fbref.com/en/players/3171351c/Pau-Navarro"
2025,"Villarreal","La Liga","Thiago Ojeda","ARG","MF","22-135",2003,0.1,0,0,0,0,0,0,0,NA,0,0,0,0,0,0,1,0,"https://fbref.com/en/players/06bb141c/Thiago-Ojeda"
2025,"Villarreal","La Liga","Daniel Parejo","ESP","MF","36-041",1989,25.3,52,40,27,20,5,29,54,53.7,25,24,7,17,24,76,40,1,"https://fbref.com/en/players/7460ca0d/Daniel-Parejo"
2025,"Villarreal","La Liga","Alfonso Pedraza","ESP","DF,MF","29-048",1996,5.1,3,2,2,0,1,2,4,50,2,3,1,2,6,9,16,0,"https://fbref.com/en/players/63f04c6c/Alfonso-Pedraza"
2025,"Villarreal","La Liga","Nicolas Pépé","CIV","FW,MF","29-363",1995,16.7,22,9,12,6,4,6,17,35.3,11,12,1,11,5,27,12,0,"https://fbref.com/en/players/57e3f0c7/Nicolas-Pepe"
2025,"Villarreal","La Liga","Ayoze Pérez","ESP","FW","31-302",1993,21.9,27,14,5,18,4,6,24,25,18,17,0,17,8,35,15,0,"https://fbref.com/en/players/819aa8e7/Ayoze-Perez"
2025,"Villarreal","La Liga","Yeremi Pino","ESP","MF,FW","22-219",2002,21.5,60,32,20,32,8,32,65,49.2,33,38,3,35,8,68,18,0,"https://fbref.com/en/players/540ec57b/Yeremi-Pino"
2025,"Villarreal","La Liga","Daniel Requena","ESP","MF","21-104",2004,0.1,0,0,0,0,0,0,0,NA,0,0,0,0,0,0,0,0,"https://fbref.com/en/players/34d29ab9/Daniel-Requena"
2025,"Villarreal","La Liga","Arnau Solà","ESP","MF","22-053",2003,0.1,0,0,0,0,0,0,2,0,2,1,1,0,0,0,0,0,"https://fbref.com/en/players/c8c8ce16/Arnau-Sola"
2025,"Villarreal","La Liga","Denis Suárez","ESP","MF","31-141",1994,6.8,12,8,7,2,3,4,10,40,6,4,1,3,3,15,3,0,"https://fbref.com/en/players/12c50af5/Denis-Suarez"
2025,"Villarreal","La Liga","Ramón Terrats","ESP","MF,FW","24-221",2000,1.5,3,3,1,2,0,2,4,50,2,3,1,2,2,5,3,0,"https://fbref.com/en/players/f36016a5/Ramon-Terrats"
2025,"Werder Bremen","Bundesliga","Felix Agu","GER","DF","25-242",1999,19.5,30,14,12,14,4,12,23,52.2,11,27,9,18,21,51,48,0,"https://fbref.com/en/players/cb6d81b3/Felix-Agu"
2025,"Werder Bremen","Bundesliga","Skelly Alvero","FRA","MF","23-023",2002,2.6,11,6,5,5,1,4,5,80,1,4,0,4,2,13,10,0,"https://fbref.com/en/players/add37c13/Skelly-Alvero"
2025,"Werder Bremen","Bundesliga","Leonardo Bittencourt","GER","MF","31-159",1993,10.9,25,9,15,7,3,6,18,33.3,12,8,0,8,15,40,11,0,"https://fbref.com/en/players/dc62fbee/Leonardo-Bittencourt"
2025,"Werder Bremen","Bundesliga","Oliver Burke","SCO","FW","28-050",1997,10.1,11,4,5,1,5,4,6,66.7,2,20,0,20,2,13,6,0,"https://fbref.com/en/players/f631c17f/Oliver-Burke"
2025,"Werder Bremen","Bundesliga","Olivier Deman","BEL","DF","25-051",2000,0.7,6,3,2,4,0,2,7,28.6,5,3,1,2,3,9,4,0,"https://fbref.com/en/players/13210854/Olivier-Deman"
2025,"Werder Bremen","Bundesliga","Marvin Ducksch","GER","FW","31-081",1994,26.9,10,7,3,5,2,3,14,21.4,11,10,2,8,8,18,26,3,"https://fbref.com/en/players/638a4d71/Marvin-Ducksch"
2025,"Werder Bremen","Bundesliga","Marco Friedl","AUT","DF","27-072",1998,24,62,42,35,26,1,38,66,57.6,28,41,24,17,34,96,130,1,"https://fbref.com/en/players/f86ad3f5/Marco-Friedl"
2025,"Werder Bremen","Bundesliga","Marco Grüll","AUT","FW,MF","26-325",1998,13.1,12,9,1,5,6,4,17,23.5,13,14,2,12,3,15,10,0,"https://fbref.com/en/players/8babb812/Marco-Grull"
2025,"Werder Bremen","Bundesliga","Anthony Jung","GER","DF","33-205",1991,21.1,34,22,22,11,1,22,34,64.7,12,23,14,9,25,59,77,1,"https://fbref.com/en/players/de838f86/Anthony-Jung"
2025,"Werder Bremen","Bundesliga","Issa Kaboré","BFA","DF,FW","24-015",2001,3.4,8,4,2,5,1,4,6,66.7,2,8,2,6,2,10,7,0,"https://fbref.com/en/players/c066d1a5/Issa-Kabore"
2025,"Werder Bremen","Bundesliga","Derrick Köhn","GER","DF,FW","26-112",1999,14.9,20,10,7,10,3,10,14,71.4,4,21,4,17,10,30,26,0,"https://fbref.com/en/players/b735b590/Derrick-Kohn"
2025,"Werder Bremen","Bundesliga","Senne Lynen","BEL","MF","26-097",1999,30.4,72,39,36,30,6,39,69,56.5,30,56,13,43,65,137,75,5,"https://fbref.com/en/players/0ed60738/Senne-Lynen"
2025,"Werder Bremen","Bundesliga","Julián Malatini","ARG","DF","23-361",2001,5,11,9,5,5,1,5,11,45.5,6,8,3,5,7,18,17,0,"https://fbref.com/en/players/8b84b707/Julian-Malatini"
2025,"Werder Bremen","Bundesliga","Keke Maximilian Topp","GER","FW,MF","21-063",2004,2.8,3,1,0,2,1,1,2,50,1,0,0,0,1,4,4,0,"https://fbref.com/en/players/ebb32f3a/Keke-Maximilian-Topp"
2025,"Werder Bremen","Bundesliga","Justin Njinmah","GER","FW,MF","24-193",2000,10.6,6,2,1,4,1,3,5,60,2,5,0,5,3,9,1,0,"https://fbref.com/en/players/a45241d5/Justin-Njinmah"
2025,"Werder Bremen","Bundesliga","Amos Pieper","GER","DF","27-130",1998,16.6,32,17,16,11,5,21,33,63.6,12,28,17,11,24,56,98,1,"https://fbref.com/en/players/526ea7cc/Amos-Pieper"
2025,"Werder Bremen","Bundesliga","Romano Schmid","AUT","MF","25-120",2000,31.5,43,25,10,22,11,24,51,47.1,27,42,3,39,11,54,9,2,"https://fbref.com/en/players/220ace7e/Romano-Schmid"
2025,"Werder Bremen","Bundesliga","André Silva","POR","FW","29-202",1995,4.2,2,2,1,1,0,0,1,0,1,3,1,2,0,2,3,0,"https://fbref.com/en/players/3effaa34/Andre-Silva"
2025,"Werder Bremen","Bundesliga","Jens Stage","DEN","MF","28-200",1996,24.5,49,30,22,24,3,25,46,54.3,21,44,10,34,18,67,42,2,"https://fbref.com/en/players/1fffae99/Jens-Stage"
2025,"Werder Bremen","Bundesliga","Niklas Stark","GER","DF","30-043",1995,23.4,33,21,20,11,2,14,21,66.7,7,41,27,14,36,69,129,1,"https://fbref.com/en/players/aad48be9/Niklas-Stark"
2025,"Werder Bremen","Bundesliga","Miloš Veljković","SRB","DF","29-243",1995,11.4,10,5,6,3,1,7,15,46.7,8,14,9,5,2,12,47,1,"https://fbref.com/en/players/a5ae8f8e/Milos-Veljkovic"
2025,"Werder Bremen","Bundesliga","Mitchell Weiser","GER","DF,MF","31-036",1994,31.9,61,40,19,34,8,28,56,50,28,33,3,30,22,83,61,3,"https://fbref.com/en/players/30c220c3/Mitchell-Weiser"
2025,"Werder Bremen","Bundesliga","Michael Zetterer","GER","GK","29-319",1995,34,0,0,0,0,0,0,1,0,1,1,0,1,1,1,10,7,"https://fbref.com/en/players/9b688ae1/Michael-Zetterer"
2025,"West Ham","Premier League","Edson Álvarez","MEX","MF","27-215",1997,19.7,50,27,27,15,8,17,35,48.6,18,23,8,15,18,68,46,1,"https://fbref.com/en/players/8b3ab7ad/Edson-Alvarez"
2025,"West Ham","Premier League","Michail Antonio","JAM","FW","35-060",1990,9.3,2,2,0,1,1,2,3,66.7,1,6,0,6,0,2,2,0,"https://fbref.com/en/players/ac05f970/Michail-Antonio"
2025,"West Ham","Premier League","Alphonse Areola","FRA","GK","32-089",1993,25.1,2,2,2,0,0,2,3,66.7,1,0,0,0,0,2,15,3,"https://fbref.com/en/players/2f965a72/Alphonse-Areola"
2025,"West Ham","Premier League","Jarrod Bowen","ENG","FW,MF","28-158",1996,33,41,26,13,12,16,19,40,47.5,21,22,4,18,16,57,25,0,"https://fbref.com/en/players/79c84d1c/Jarrod-Bowen"
2025,"West Ham","Premier League","Kaelan Casey","ENG","DF","20-211",2004,0,0,0,0,0,0,0,0,NA,0,0,0,0,0,0,1,0,"https://fbref.com/en/players/cd4b2c5f/Kaelan-Casey"
2025,"West Ham","Premier League","Vladimír Coufal","CZE","DF","32-278",1992,11.9,22,15,13,7,2,10,22,45.5,12,13,11,2,8,30,39,1,"https://fbref.com/en/players/fdf3cb77/Vladimir-Coufal"
2025,"West Ham","Premier League","Aaron Cresswell","ENG","DF","35-163",1989,9.2,11,7,5,5,1,9,11,81.8,2,9,4,5,8,19,37,0,"https://fbref.com/en/players/4f974391/Aaron-Cresswell"
2025,"West Ham","Premier League","Łukasz Fabiański","POL","GK","40-039",1985,12.9,0,0,0,0,0,0,1,0,1,0,0,0,0,0,5,1,"https://fbref.com/en/players/9328b835/Lukasz-Fabianski"
2025,"West Ham","Premier League","Evan Ferguson","IRL","FW","20-220",2004,1.7,3,1,0,1,2,0,0,NA,0,2,1,1,1,4,1,0,"https://fbref.com/en/players/4596da74/Evan-Ferguson"
2025,"West Ham","Premier League","Niclas Füllkrug","GER","FW","32-107",1993,8.8,4,3,0,1,3,3,4,75,1,1,0,1,1,5,16,0,"https://fbref.com/en/players/4f16405e/Niclas-Fullkrug"
2025,"West Ham","Premier League","Luis Guilherme","BRA","MF,FW","19-107",2006,1.7,1,0,1,0,0,0,3,0,3,7,0,7,3,4,2,0,"https://fbref.com/en/players/b7672d43/Luis-Guilherme"
2025,"West Ham","Premier League","Danny Ings","ENG","FW,MF","32-308",1992,3.2,4,2,2,2,0,1,3,33.3,2,5,0,5,1,5,4,0,"https://fbref.com/en/players/07802f7f/Danny-Ings"
2025,"West Ham","Premier League","Andy Irving","SCO","MF","25-014",2000,1.8,7,4,3,3,1,1,5,20,4,5,1,4,1,8,5,0,"https://fbref.com/en/players/b1be9fc0/Andy-Irving"
2025,"West Ham","Premier League","Max Kilman","ENG","DF","28-004",1997,37.2,39,24,16,20,3,23,27,85.2,4,58,40,18,38,77,212,6,"https://fbref.com/en/players/d0f72bf1/Max-Kilman"
2025,"West Ham","Premier League","Mohammed Kudus","GHA","FW,MF","24-298",2000,28.8,38,23,9,18,11,10,27,37,17,24,1,23,4,42,8,2,"https://fbref.com/en/players/b62878a5/Mohammed-Kudus"
2025,"West Ham","Premier League","Konstantinos Mavropanos","GRE","DF","27-167",1997,22.7,35,24,24,10,1,16,27,59.3,11,25,18,7,40,75,126,1,"https://fbref.com/en/players/00963611/Konstantinos-Mavropanos"
2025,"West Ham","Premier League","Lewis Orford","ENG","MF","19-098",2006,0.5,0,0,0,0,0,0,0,NA,0,1,0,1,1,1,0,0,"https://fbref.com/en/players/40aaa04c/Lewis-Orford"
2025,"West Ham","Premier League","Emerson Palmieri","ITA","DF","30-297",1994,23.5,60,31,37,18,5,27,48,56.3,21,32,8,24,21,81,59,0,"https://fbref.com/en/players/e0bc6fdc/Emerson-Palmieri"
2025,"West Ham","Premier League","Lucas Paquetá","BRA","MF,FW","27-273",1997,26.4,66,37,25,30,11,27,55,49.1,28,29,4,25,18,84,37,6,"https://fbref.com/en/players/9b6f7fd5/Lucas-Paqueta"
2025,"West Ham","Premier League","Guido Rodríguez","ARG","MF","31-045",1994,12.8,36,19,21,15,0,17,33,51.5,16,23,9,14,13,49,35,1,"https://fbref.com/en/players/34e393f2/Guido-Rodriguez"
2025,"West Ham","Premier League","Oliver Scarles","ENG","DF,FW","19-166",2005,7.4,21,11,17,3,1,14,22,63.6,8,14,2,12,11,32,26,0,"https://fbref.com/en/players/242e5e6d/Oliver-Scarles"
2025,"West Ham","Premier League","Carlos Soler","ESP","MF,FW","28-145",1997,15.6,16,11,9,6,1,7,23,30.4,16,19,6,13,8,24,21,2,"https://fbref.com/en/players/fed17f5a/Carlos-Soler"
2025,"West Ham","Premier League","Tomáš Souček","CZE","MF","30-089",1995,28.5,46,21,20,23,3,26,44,59.1,18,41,21,20,20,66,85,1,"https://fbref.com/en/players/6613c819/Tomas-Soucek"
2025,"West Ham","Premier League","Crysencio Summerville","NED","FW,MF","23-209",2001,8.7,13,7,2,8,3,3,9,33.3,6,13,4,9,0,13,7,0,"https://fbref.com/en/players/df04eb4b/Crysencio-Summerville"
2025,"West Ham","Premier League","Jean-Clair Todibo","FRA","DF","25-148",1999,20.3,47,28,30,15,2,26,36,72.2,10,25,13,12,26,73,83,3,"https://fbref.com/en/players/88f130ed/Jean-Clair-Todibo"
2025,"West Ham","Premier League","Aaron Wan-Bissaka","ENG","DF","27-182",1997,35,70,49,33,32,5,23,32,71.9,9,37,11,26,66,136,125,0,"https://fbref.com/en/players/9e525177/Aaron-Wan-Bissaka"
2025,"West Ham","Premier League","James Ward-Prowse","ENG","MF","30-207",1994,11.6,20,14,8,8,4,7,19,36.8,12,6,3,3,8,28,15,0,"https://fbref.com/en/players/3515d404/James-Ward-Prowse"
2025,"Wolfsburg","Bundesliga","Mohamed Amoura","ALG","FW","25-018",2000,27.4,29,22,14,5,10,14,37,37.8,23,42,2,40,9,38,24,0,"https://fbref.com/en/players/6597f8b6/Mohamed-Amoura"
2025,"Wolfsburg","Bundesliga","Maximilian Arnold","GER","MF","31-000",1994,26.2,34,20,13,18,3,15,33,45.5,18,21,11,10,24,58,70,2,"https://fbref.com/en/players/86e119e0/Maximilian-Arnold"
2025,"Wolfsburg","Bundesliga","Ridle Baku","GER","FW,MF","27-049",1998,13,23,15,9,9,5,8,19,42.1,11,22,1,21,15,38,15,0,"https://fbref.com/en/players/442b56fa/Ridle-Baku"
2025,"Wolfsburg","Bundesliga","Kevin Behrens","GER","FW","34-113",1991,1.9,1,1,0,1,0,0,1,0,1,0,0,0,1,2,2,0,"https://fbref.com/en/players/30ae134d/Kevin-Behrens"
2025,"Wolfsburg","Bundesliga","Sebastiaan Bornauw","BEL","DF","26-066",1999,8.8,9,6,4,4,1,4,8,50,4,14,12,2,12,21,36,0,"https://fbref.com/en/players/01834aa0/Sebastiaan-Bornauw"
2025,"Wolfsburg","Bundesliga","Bence Dárdai","HUN","MF","19-123",2006,14.5,24,14,9,13,2,16,30,53.3,14,20,4,16,12,36,28,1,"https://fbref.com/en/players/dcb6f03c/Bence-Dardai"
2025,"Wolfsburg","Bundesliga","Kilian Fischer","GER","DF","24-227",2000,25.5,64,44,48,12,4,47,89,52.8,42,41,8,33,19,83,98,2,"https://fbref.com/en/players/79f7302a/Kilian-Fischer"
2025,"Wolfsburg","Bundesliga","Yannick Gerhardt","GER","MF,DF","31-075",1994,16.9,28,16,13,14,1,11,30,36.7,19,32,8,24,17,45,47,0,"https://fbref.com/en/players/62ab9184/Yannick-Gerhardt"
2025,"Wolfsburg","Bundesliga","Kamil Grabara","POL","GK","26-139",1999,28.7,0,0,0,0,0,0,2,0,2,1,0,1,0,0,16,2,"https://fbref.com/en/players/62182b1d/Kamil-Grabara"
2025,"Wolfsburg","Bundesliga","Jakub Kamiński","POL","DF,MF","22-356",2002,12.6,17,8,8,3,6,9,22,40.9,13,17,7,10,13,30,23,1,"https://fbref.com/en/players/202b3b68/Jakub-Kaminski"
2025,"Wolfsburg","Bundesliga","Konstantinos Koulierakis","GRE","DF","21-180",2003,27.4,40,20,25,13,2,25,40,62.5,15,34,14,20,33,73,147,2,"https://fbref.com/en/players/cba21b0d/Konstantinos-Koulierakis"
2025,"Wolfsburg","Bundesliga","Lovro Majer","CRO","MF","27-130",1998,3.4,2,1,0,1,1,1,5,20,4,5,1,4,1,3,2,1,"https://fbref.com/en/players/fc46aab1/Lovro-Majer"
2025,"Wolfsburg","Bundesliga","Marius Müller","GER","GK","31-319",1993,5.3,0,0,0,0,0,0,0,NA,0,0,0,0,0,0,0,0,"https://fbref.com/en/players/04ac779b/Marius-Muller"
2025,"Wolfsburg","Bundesliga","Joakim Mæhle","DEN","DF","28-007",1997,24.3,34,15,26,6,2,17,45,37.8,28,24,3,21,25,59,57,2,"https://fbref.com/en/players/c459a650/Joakim-Maehle"
2025,"Wolfsburg","Bundesliga","Lukas Nmecha","GER","FW,MF","26-164",1998,5.2,2,0,1,1,0,0,1,0,1,3,0,3,2,4,4,0,"https://fbref.com/en/players/0cc5f4a5/Lukas-Nmecha"
2025,"Wolfsburg","Bundesliga","David Odogu","GER","DF","18-358",2006,2.2,6,4,4,2,0,3,5,60,2,2,2,0,2,8,25,1,"https://fbref.com/en/players/6a58d68c/David-Odogu"
2025,"Wolfsburg","Bundesliga","Salih Özcan","TUR","MF","27-136",1998,3.9,2,2,1,0,1,1,5,20,4,5,1,4,7,9,5,0,"https://fbref.com/en/players/15413fa5/Salih-Ozcan"
2025,"Wolfsburg","Bundesliga","Kevin Paredes","USA","DF","22-020",2003,1.4,3,1,3,0,0,2,3,66.7,1,2,2,0,1,4,0,0,"https://fbref.com/en/players/5c50fdbc/Kevin-Paredes"
2025,"Wolfsburg","Bundesliga","Mads Roerslev","DEN","DF","25-337",1999,3.3,10,9,8,1,1,6,9,66.7,3,2,2,0,5,15,16,0,"https://fbref.com/en/players/57c94db2/Mads-Roerslev"
2025,"Wolfsburg","Bundesliga","Andreas Skov Olsen","DEN","FW,MF","25-149",1999,5.9,8,6,5,3,0,4,4,100,0,4,0,4,2,10,12,0,"https://fbref.com/en/players/c50cee19/Andreas-Skov-Olsen"
2025,"Wolfsburg","Bundesliga","Mattias Svanberg","SWE","MF","26-142",1999,13.5,20,10,6,11,3,9,19,47.4,10,11,4,7,15,35,26,0,"https://fbref.com/en/players/92d83c27/Mattias-Svanberg"
2025,"Wolfsburg","Bundesliga","Tiago Tomás","POR","FW,MF","22-345",2002,20.9,33,19,15,11,7,15,35,42.9,20,17,4,13,9,42,19,0,"https://fbref.com/en/players/b492126a/Tiago-Tomas"
2025,"Wolfsburg","Bundesliga","Denis Vavro","SVK","DF","29-047",1996,27.3,21,13,16,5,0,11,23,47.8,12,48,32,16,37,58,234,3,"https://fbref.com/en/players/08990838/Denis-Vavro"
2025,"Wolfsburg","Bundesliga","Aster Vranckx","BEL","MF","22-235",2002,6.2,11,6,3,8,0,3,9,33.3,6,14,3,11,10,21,13,0,"https://fbref.com/en/players/f86cd5df/Aster-Vranckx"
2025,"Wolfsburg","Bundesliga","Patrick Wimmer","AUT","MF,FW","23-362",2001,19.7,47,35,19,21,7,15,46,32.6,31,31,4,27,32,79,15,2,"https://fbref.com/en/players/cb11b429/Patrick-Wimmer"
2025,"Wolfsburg","Bundesliga","Jonas Wind","DEN","FW,MF","26-109",1999,21.8,10,6,1,8,1,4,8,50,4,17,3,14,6,16,15,0,"https://fbref.com/en/players/2077ae86/Jonas-Wind"
2025,"Wolfsburg","Bundesliga","Cedric Zesiger","SUI","DF","26-337",1998,5.8,13,8,6,5,2,6,12,50,6,6,5,1,3,16,28,0,"https://fbref.com/en/players/2bab583c/Cedric-Zesiger"
2025,"Wolves","Premier League","Emmanuel Agbadou","CIV","DF","27-344",1997,15.7,30,19,21,9,0,13,20,65,7,19,13,6,12,42,90,0,"https://fbref.com/en/players/75f1ed80/Emmanuel-Agbadou"
2025,"Wolves","Premier League","Rayan Aït-Nouri","ALG","DF","23-355",2001,34.5,89,57,52,28,9,43,70,61.4,27,42,6,36,26,115,75,2,"https://fbref.com/en/players/9b398aea/Rayan-Ait-Nouri"
2025,"Wolves","Premier League","André","BRA","MF","23-315",2001,27.5,91,55,41,41,9,37,63,58.7,26,42,8,34,37,128,30,1,"https://fbref.com/en/players/ec604e2c/Andre"
2025,"Wolves","Premier League","Jean-Ricner Bellegarde","FRA","MF,FW","26-334",1998,18.6,39,24,17,19,3,14,20,70,6,19,3,16,10,49,18,1,"https://fbref.com/en/players/10f0fdd3/Jean-Ricner-Bellegarde"
2025,"Wolves","Premier League","Daniel Bentley","ENG","GK","31-318",1993,2,0,0,0,0,0,0,0,NA,0,0,0,0,0,0,1,0,"https://fbref.com/en/players/68db6358/Daniel-Bentley"
2025,"Wolves","Premier League","Santiago Bueno","URU","DF","26-199",1998,18.7,41,21,22,18,1,17,22,77.3,5,36,21,15,15,56,70,0,"https://fbref.com/en/players/edc98fac/Santiago-Bueno"
2025,"Wolves","Premier League","Chiquinho","POR","MF","25-111",2000,0.1,0,0,0,0,0,0,0,NA,0,0,0,0,0,0,0,0,"https://fbref.com/en/players/dc6c2f02/Chiquinho"
2025,"Wolves","Premier League","Matheus Cunha","BRA","MF,FW","26-000",1999,28.9,38,22,17,16,5,13,39,33.3,26,21,1,20,17,55,23,0,"https://fbref.com/en/players/dc62b55d/Matheus-Cunha"
2025,"Wolves","Premier League","Craig Dawson","ENG","DF","35-021",1990,10.8,15,3,8,6,1,12,15,80,3,16,11,5,9,24,52,1,"https://fbref.com/en/players/3e9e06cb/Craig-Dawson"
2025,"Wolves","Premier League","Nasser Djiga","BFA","DF","22-193",2002,0.7,0,0,0,0,0,0,1,0,1,0,0,0,2,2,4,1,"https://fbref.com/en/players/1a7a4d84/Nasser-Djiga"
2025,"Wolves","Premier League","Matt Doherty","IRL","DF","33-131",1992,23.4,38,21,25,13,0,17,25,68,8,28,15,13,22,60,102,3,"https://fbref.com/en/players/d557d734/Matt-Doherty"
2025,"Wolves","Premier League","Tommy Doyle","ENG","MF","23-222",2001,5.4,11,6,6,3,2,6,15,40,9,11,5,6,5,16,11,1,"https://fbref.com/en/players/5526deb1/Tommy-Doyle"
2025,"Wolves","Premier League","Carlos Forbs","POR","MF,FW","21-069",2004,2.7,8,5,5,2,1,4,6,66.7,2,3,0,3,1,9,2,1,"https://fbref.com/en/players/8a310070/Carlos-Forbs"
2025,"Wolves","Premier League","João Gomes","BRA","MF","24-104",2001,33,116,71,55,53,8,48,110,43.6,62,42,4,38,25,141,33,0,"https://fbref.com/en/players/8b57ad2c/Joao-Gomes"
2025,"Wolves","Premier League","Rodrigo Gomes","POR","DF,FW","21-324",2003,9,23,15,14,9,0,12,21,57.1,9,8,1,7,7,30,20,1,"https://fbref.com/en/players/8dcf77c0/Rodrigo-Gomes"
2025,"Wolves","Premier League","Toti Gomes","POR","DF","26-131",1999,29,61,43,42,15,4,37,46,80.4,9,29,17,12,25,86,152,5,"https://fbref.com/en/players/f0caab96/Toti-Gomes"
2025,"Wolves","Premier League","Gonçalo Guedes","POR","MF,FW","28-179",1996,11.1,16,5,2,6,8,4,16,25,12,11,0,11,5,21,4,0,"https://fbref.com/en/players/e6bc67d7/Goncalo-Guedes"
2025,"Wolves","Premier League","Hwang Hee-chan","KOR","MF,FW","29-121",1996,7.3,6,4,2,1,3,2,6,33.3,4,9,0,9,2,8,11,0,"https://fbref.com/en/players/169fd162/Hwang-Hee-chan"
2025,"Wolves","Premier League","Sam Johnstone","ENG","GK","32-063",1993,7,0,0,0,0,0,0,1,0,1,0,0,0,0,0,7,0,"https://fbref.com/en/players/9e5708be/Sam-Johnstone"
2025,"Wolves","Premier League","Tom King","WAL","GK","30-079",1995,0,0,0,0,0,0,0,0,NA,0,0,0,0,0,0,0,0,"https://fbref.com/en/players/5791b997/Tom-King"
2025,"Wolves","Premier League","Mario Lemina","GAB","MF,DF","31-268",1993,15.2,51,31,27,19,5,20,29,69,9,12,7,5,27,78,50,3,"https://fbref.com/en/players/2b471f99/Mario-Lemina"
2025,"Wolves","Premier League","Pedro Lima","BRA","DF","18-330",2006,0.8,1,0,0,0,1,1,3,33.3,2,0,0,0,2,3,5,0,"https://fbref.com/en/players/b2f4cad5/Pedro-Lima"
2025,"Wolves","Premier League","Mateus Mane","","MF","",NA,0,0,0,0,0,0,0,0,NA,0,1,0,1,0,0,0,0,"https://fbref.com/en/players/c15cb409/Mateus-Mane"
2025,"Wolves","Premier League","Yerson Mosquera","COL","DF","24-025",2001,4.9,11,7,9,2,0,9,14,64.3,5,13,10,3,10,21,14,0,"https://fbref.com/en/players/1e159d70/Yerson-Mosquera"
2025,"Wolves","Premier League","Marshall Munetsi","ZIM","MF,FW","28-339",1996,12,24,10,7,11,6,13,23,56.5,10,14,1,13,6,30,18,0,"https://fbref.com/en/players/2acf0cd7/Marshall-Munetsi"
2025,"Wolves","Premier League","Daniel Podence","POR","MF,FW","29-218",1995,0.5,0,0,0,0,0,0,1,0,1,0,0,0,0,0,0,0,"https://fbref.com/en/players/7fcc71d8/Daniel-Podence"
2025,"Wolves","Premier League","Alfie Pond","ENG","DF","21-087",2004,0,0,0,0,0,0,0,0,NA,0,0,0,0,0,0,0,0,"https://fbref.com/en/players/039c3d96/Alfie-Pond"
2025,"Wolves","Premier League","José Sá","POR","GK","32-130",1993,29,2,2,2,0,0,2,2,100,0,0,0,0,0,2,15,1,"https://fbref.com/en/players/903b6e8b/Jose-Sa"
2025,"Wolves","Premier League","Pablo Sarabia","ESP","MF,FW","33-016",1992,9,16,8,4,8,4,10,16,62.5,6,10,0,10,4,20,7,1,"https://fbref.com/en/players/9744ff80/Pablo-Sarabia"
2025,"Wolves","Premier League","Nélson Semedo","POR","DF","31-192",1993,32.1,62,36,32,21,9,34,57,59.6,23,32,10,22,23,85,104,3,"https://fbref.com/en/players/d04b94db/Nelson-Semedo"
2025,"Wolves","Premier League","Jørgen Strand Larsen","NOR","FW","25-110",2000,28.7,10,6,2,3,5,4,27,14.8,23,19,4,15,6,16,29,0,"https://fbref.com/en/players/f553b2b3/Jorgen-Strand-Larsen"
2025,"Wolves","Premier League","Boubacar Traoré","MLI","MF","23-280",2001,0,2,0,0,2,0,1,1,100,0,0,0,0,0,2,0,0,"https://fbref.com/en/players/999ceb5f/Boubacar-Traore"
